filename,CorrectPosition,focus_time,index,label,pred,loss
home1_0,29,1,23,6,-0.24831731617450714,6.248317241668701
home1_0,29,2,23,6,-6.182316780090332,12.182316780090332
home1_0,29,3,17,12,14.44931697845459,2.44931697845459
home1_1,23,1,29,-6,-10.426956176757812,4.4269561767578125
home1_1,23,2,19,4,1.4887906312942505,2.511209487915039
home1_2,34,1,45,-11,-1.7516168355941772,9.248383522033691
home1_2,34,2,43,-9,-3.117647647857666,5.882352352142334
home1_2,34,3,40,-6,6.29152250289917,12.291522979736328
home1_2,34,4,46,-12,-6.0804972648620605,5.9195027351379395
home1_2,34,5,40,-6,2.523834228515625,8.523834228515625
home1_2,34,6,43,-9,2.045412302017212,11.045412063598633
home1_2,34,7,45,-11,0.49551329016685486,11.495512962341309
home1_3,30,1,9,21,25.901588439941406,4.901588439941406
home1_3,30,2,35,-5,-1.940657615661621,3.059342384338379
home1_3,30,3,33,-3,12.738612174987793,15.738612174987793
home1_3,30,4,46,-16,-7.770003318786621,8.229996681213379
home1_3,30,5,38,-8,3.2988336086273193,11.298833847045898
home1_3,30,6,41,-11,-2.759448528289795,8.240550994873047
home1_3,30,7,38,-8,-9.209345817565918,1.209345817565918
home1_5,33,1,27,6,31.892168045043945,25.892168045043945
home1_5,33,2,48,-15,11.218484878540039,26.21848487854004
home1_5,33,3,48,-15,9.786202430725098,24.78620147705078
home1_5,33,4,48,-15,-3.508453369140625,11.491546630859375
home1_5,33,5,44,-11,11.200392723083496,22.200393676757812
home1_5,33,6,48,-15,-3.2897918224334717,11.71020793914795
home1_5,33,7,45,-12,2.676565170288086,14.676565170288086
home1_6,32,1,41,-9,-11.713725090026855,2.7137250900268555
home1_8,31,1,42,-11,-5.968684673309326,5.031315326690674
home1_8,31,2,36,-5,15.244359970092773,20.244359970092773
home1_8,31,3,48,-17,-15.021469116210938,1.9785308837890625
home1_9,25,1,28,-3,3.6103508472442627,6.610350608825684
home1_9,25,2,32,-7,3.2109944820404053,10.210994720458984
home1_9,25,3,35,-10,-8.949563980102539,1.050436019897461
home2_0,36,1,25,11,18.690153121948242,7.690153121948242
home2_0,36,2,44,-8,-2.637960433959961,5.362039566040039
home2_0,36,3,41,-5,6.3507795333862305,11.35077953338623
home2_0,36,4,47,-11,-9.354510307312012,1.6454896926879883
home2_1,37,1,13,24,43.0528564453125,19.0528564453125
home2_1,37,2,48,-11,22.207351684570312,33.20735168457031
home2_1,37,3,48,-11,22.390792846679688,33.39079284667969
home2_1,37,4,48,-11,17.09786033630371,28.09786033630371
home2_1,37,5,48,-11,19.290359497070312,30.290359497070312
home2_1,37,6,48,-11,16.899736404418945,27.899736404418945
home2_1,37,7,48,-11,17.54261016845703,28.54261016845703
home2_2,36,1,13,23,-0.680785596370697,23.6807861328125
home2_2,36,2,12,24,-5.425041198730469,29.42504119873047
home2_2,36,3,7,29,-14.924596786499023,43.924598693847656
home2_2,36,4,0,36,-8.97208023071289,44.97208023071289
home2_2,36,5,0,36,-7.142260551452637,43.14226150512695
home2_2,36,6,0,36,4.819730281829834,31.180269241333008
home2_2,36,7,5,31,2.2237706184387207,28.776229858398438
home2_3,29,1,5,24,27.091753005981445,3.0917530059814453
home2_3,29,2,32,-3,6.062896728515625,9.062896728515625
home2_3,29,3,38,-9,-0.8633202314376831,8.136679649353027
home2_3,29,4,37,-8,-3.6154942512512207,4.384505748748779
home2_3,29,5,33,-4,5.004067420959473,9.004067420959473
home2_3,29,6,38,-9,-0.27443981170654297,8.725560188293457
home2_3,29,7,38,-9,-0.8770049214363098,8.122995376586914
home2_4,34,1,2,32,14.790477752685547,17.209522247314453
home2_4,34,2,17,17,-10.300288200378418,27.300289154052734
home2_4,34,3,7,27,10.642048835754395,16.357952117919922
home2_4,34,4,18,16,-6.6606316566467285,22.66063117980957
home2_4,34,5,11,23,-6.738138198852539,29.73813819885254
home2_4,34,6,4,30,3.2975375652313232,26.702463150024414
home2_4,34,7,7,27,-8.567964553833008,35.567962646484375
home2_5,29,1,47,-18,-13.283349990844727,4.716650009155273
home2_5,29,2,34,-5,9.314607620239258,14.314607620239258
home2_5,29,3,43,-14,-2.9122707843780518,11.087729454040527
home2_5,29,4,40,-11,-1.044653058052063,9.955347061157227
home2_5,29,5,39,-10,-7.998603820800781,2.0013961791992188
home2_6,25,1,7,18,24.775745391845703,6.775745391845703
home2_6,25,2,32,-7,5.720330715179443,12.720331192016602
home2_6,25,3,38,-13,-13.04884147644043,0.04884147644042969
home2_7,36,1,24,12,17.67434310913086,5.674343109130859
home2_7,36,2,42,-6,-9.738807678222656,3.7388076782226562
home2_7,36,3,32,4,20.905635833740234,16.905635833740234
home2_7,36,4,48,-12,-16.428096771240234,4.428096771240234
home2_7,36,5,32,4,11.180843353271484,7.180843353271484
home2_7,36,6,43,-7,-15.532761573791504,8.532761573791504
home2_7,36,7,27,9,21.42599868774414,12.42599868774414
home2_8,34,1,44,-10,-0.37630605697631836,9.623693466186523
home2_8,34,2,44,-10,0.8452677726745605,10.845268249511719
home2_8,34,3,45,-11,-5.074230194091797,5.925769805908203
home2_8,34,4,40,-6,8.146390914916992,14.146390914916992
home2_8,34,5,48,-14,2.7453339099884033,16.74533462524414
home2_8,34,6,48,-14,6.143266677856445,20.143266677856445
home2_8,34,7,48,-14,-7.084908485412598,6.915091514587402
home2_9,28,1,41,-13,-15.411267280578613,2.4112672805786133
microkitchen1_0,21,1,28,-7,-11.004902839660645,4.0049028396606445
microkitchen1_0,21,2,17,4,4.960171699523926,0.9601716995239258
microkitchen1_1,21,1,11,10,13.287795066833496,3.287795066833496
microkitchen1_1,21,2,24,-3,1.564827561378479,4.5648274421691895
microkitchen1_1,21,3,26,-5,1.3272134065628052,6.327213287353516
microkitchen1_1,21,4,27,-6,-0.7314273715019226,5.268572807312012
microkitchen1_1,21,5,26,-5,-2.049830913543701,2.950169086456299
microkitchen1_2,21,1,3,18,30.759471893310547,12.759471893310547
microkitchen1_2,21,2,34,-13,-11.450836181640625,1.549163818359375
microkitchen1_3,24,1,39,-15,-18.29681968688965,3.2968196868896484
microkitchen1_3,24,2,21,3,9.976213455200195,6.976213455200195
microkitchen1_3,24,3,31,-7,-0.14127500355243683,6.858725070953369
microkitchen1_3,24,4,31,-7,-19.014307022094727,12.014307022094727
microkitchen1_3,24,5,12,12,18.485614776611328,6.485614776611328
microkitchen1_3,24,6,30,-6,-4.606097221374512,1.3939027786254883
microkitchen1_4,25,1,18,7,12.91291332244873,5.9129133224487305
microkitchen1_4,25,2,31,-6,4.87360143661499,10.873601913452148
microkitchen1_4,25,3,36,-11,-5.471474647521973,5.528525352478027
microkitchen1_4,25,4,31,-6,4.352586269378662,10.35258674621582
microkitchen1_4,25,5,35,-10,-3.548837184906006,6.451162815093994
microkitchen1_4,25,6,31,-6,2.9030580520629883,8.903058052062988
microkitchen1_4,25,7,34,-9,-4.803669452667236,4.196330547332764
microkitchen1_5,24,1,26,-2,5.239383697509766,7.239383697509766
microkitchen1_5,24,2,31,-7,-7.411623001098633,0.4116230010986328
microkitchen1_6,25,1,28,-3,7.441034317016602,10.441034317016602
microkitchen1_6,25,2,35,-10,-1.0344280004501343,8.965572357177734
microkitchen1_6,25,3,34,-9,-1.2744544744491577,7.725545406341553
microkitchen1_6,25,4,33,-8,2.494772434234619,10.494771957397461
microkitchen1_6,25,5,35,-10,3.789325475692749,13.789325714111328
microkitchen1_6,25,6,39,-14,-5.430661201477051,8.56933879852295
microkitchen1_6,25,7,34,-9,2.229243278503418,11.229243278503418
microkitchen1_7,23,1,29,-6,-9.550333976745605,3.5503339767456055
microkitchen1_7,23,2,19,4,9.086545944213867,5.086545944213867
microkitchen1_7,23,3,28,-5,-14.431414604187012,9.431414604187012
microkitchen1_7,23,4,14,9,15.244205474853516,6.244205474853516
microkitchen1_7,23,5,29,-6,-12.827999114990234,6.827999114990234
microkitchen1_7,23,6,16,7,11.480710983276367,4.480710983276367
microkitchen1_7,23,7,27,-4,-12.053043365478516,8.053043365478516
microkitchen1_8,27,1,29,-2,8.755010604858398,10.755010604858398
microkitchen1_8,27,2,38,-11,1.4718126058578491,12.47181224822998
microkitchen1_8,27,3,39,-12,-8.800285339355469,3.1997146606445312
microkitchen1_8,27,4,30,-3,1.451208233833313,4.451208114624023
microkitchen1_8,27,5,31,-4,1.7764712572097778,5.776471138000488
microkitchen1_8,27,6,33,-6,2.9587435722351074,8.958744049072266
microkitchen1_8,27,7,36,-9,0.23422446846961975,9.234224319458008
microkitchen1_9,20,1,24,-4,-8.46288013458252,4.4628801345825195
microkitchen1_9,20,2,16,4,3.725853204727173,0.27414679527282715
pillowroom1_0,39,1,28,11,24.69872283935547,13.698722839355469
pillowroom1_0,39,2,48,-9,-7.581257343292236,1.4187426567077637
pillowroom1_1,42,1,33,9,23.811307907104492,14.811307907104492
pillowroom1_1,42,2,48,-6,7.886959552764893,13.886959075927734
pillowroom1_1,42,3,48,-6,-1.4884119033813477,4.511588096618652
pillowroom1_1,42,4,47,-5,3.0539419651031494,8.05394172668457
pillowroom1_1,42,5,48,-6,-0.18435770273208618,5.815642356872559
pillowroom1_1,42,6,48,-6,5.720175743103027,11.720175743103027
pillowroom1_1,42,7,48,-6,7.123581409454346,13.123580932617188
pillowroom1_2,37,1,10,27,9.541754722595215,17.45824432373047
pillowroom1_2,37,2,20,17,20.36357307434082,3.3635730743408203
pillowroom1_2,37,3,40,-3,-11.421514511108398,8.421514511108398
pillowroom1_2,37,4,29,8,-1.2156682014465332,9.215667724609375
pillowroom1_2,37,5,28,9,-10.746886253356934,19.74688720703125
pillowroom1_2,37,6,17,20,23.201969146728516,3.2019691467285156
pillowroom1_2,37,7,40,-3,-10.676225662231445,7.676225662231445
pillowroom1_5,44,1,31,13,20.199127197265625,7.199127197265625
pillowroom1_5,44,2,48,-4,-10.672325134277344,6.672325134277344
pillowroom1_5,44,3,37,7,10.310317039489746,3.310317039489746
pillowroom1_5,44,4,47,-3,-6.859388828277588,3.859388828277588
pillowroom1_5,44,5,40,4,2.2592320442199707,1.7407679557800293
pillowroom1_6,26,1,9,17,26.681961059570312,9.681961059570312
pillowroom1_6,26,2,36,-10,-3.9678120613098145,6.0321879386901855
pillowroom1_6,26,3,32,-6,1.5323944091796875,7.5323944091796875
pillowroom1_6,26,4,34,-8,3.4251468181610107,11.42514705657959
pillowroom1_6,26,5,37,-11,-14.30745792388916,3.30745792388916
pillowroom1_6,26,6,23,3,10.908592224121094,7.908592224121094
pillowroom1_6,26,7,34,-8,-6.510470390319824,1.4895296096801758
pillowroom1_7,36,1,27,9,13.17188835144043,4.17188835144043
pillowroom1_7,36,2,40,-4,-3.2805330753326416,0.7194669246673584
pillowroom1_8,32,1,19,13,14.656155586242676,1.6561555862426758
pillowroom1_9,22,1,48,-26,-39.62860870361328,13.628608703613281
pillowroom1_9,22,2,8,14,27.266666412353516,13.266666412353516
pillowroom1_9,22,3,35,-13,-20.02082061767578,7.020820617675781
pillowroom1_9,22,4,15,7,10.666138648986816,3.6661386489868164
pillowroom1_9,22,5,26,-4,-13.983298301696777,9.983298301696777
pillowroom1_9,22,6,12,10,14.88288688659668,4.88288688659668
pillowroom1_9,22,7,27,-5,-11.077326774597168,6.077326774597168
secondfloorgames_0,20,1,9,11,14.257390975952148,3.2573909759521484
secondfloorgames_0,20,2,23,-3,-5.932677268981934,2.9326772689819336
secondfloorgames_1,20,1,22,-2,22.606449127197266,24.606449127197266
secondfloorgames_1,20,2,45,-25,1.1069867610931396,26.10698699951172
secondfloorgames_1,20,3,46,-26,-13.136377334594727,12.863622665405273
secondfloorgames_1,20,4,33,-13,-10.2615327835083,2.738467216491699
secondfloorgames_2,23,1,2,21,25.69243049621582,4.69243049621582
secondfloorgames_2,23,2,28,-5,-5.9342827796936035,0.9342827796936035
secondfloorgames_3,25,1,2,23,37.65163040161133,14.651630401611328
secondfloorgames_3,25,2,40,-15,-10.373653411865234,4.626346588134766
secondfloorgames_3,25,3,30,-5,3.011664867401123,8.011665344238281
secondfloorgames_3,25,4,33,-8,-5.835903167724609,2.1640968322753906
secondfloorgames_4,23,1,10,13,14.088691711425781,1.0886917114257812
secondfloorgames_5,25,1,33,-8,-0.4868375360965729,7.513162612915039
secondfloorgames_5,25,2,33,-8,16.920120239257812,24.920120239257812
secondfloorgames_5,25,3,48,-23,-18.978816986083984,4.021183013916016
secondfloorgames_5,25,4,29,-4,-1.3830949068069458,2.6169052124023438
secondfloorgames_6,24,1,1,23,29.951623916625977,6.951623916625977
secondfloorgames_6,24,2,31,-7,-10.060074806213379,3.060074806213379
secondfloorgames_6,24,3,21,3,0.9589576721191406,2.0410423278808594
secondfloorgames_7,24,1,29,-5,-2.2013649940490723,2.7986350059509277
secondfloorgames_8,22,1,31,-9,-9.682623863220215,0.6826238632202148
secondfloorgames_9,43,1,19,24,27.574928283691406,3.5749282836914062
secondfloorgames_9,43,2,47,-4,-6.784093379974365,2.7840933799743652
apt1_0,25,1,27,-2,-0.30385860800743103,1.6961413621902466
apt1_1,21,1,13,8,8.531987190246582,0.531987190246582
apt1_2,23,1,36,-13,-11.099681854248047,1.9003181457519531
apt1_3,25,1,0,25,25.444828033447266,0.4448280334472656
apt1_4,22,1,40,-18,-10.73434066772461,7.265659332275391
apt1_4,22,2,29,-7,8.737258911132812,15.737258911132812
apt1_4,22,3,38,-16,4.415450096130371,20.415451049804688
apt1_4,22,4,42,-20,-12.300907135009766,7.699092864990234
apt1_4,22,5,30,-8,-15.782500267028809,7.782500267028809
apt1_4,22,6,14,8,-7.389700412750244,15.389699935913086
apt1_4,22,7,7,15,7.034743309020996,7.965256690979004
apt1_5,22,1,38,-16,15.520723342895508,31.520723342895508
apt1_5,22,2,48,-26,15.012877464294434,41.01287841796875
apt1_5,22,3,48,-26,3.351365566253662,29.35136604309082
apt1_5,22,4,48,-26,-4.139621257781982,21.86037826538086
apt1_5,22,5,44,-22,-17.71695327758789,4.283046722412109
apt1_5,22,6,26,-4,-8.471384048461914,4.471384048461914
apt1_5,22,7,18,4,-8.19302749633789,12.19302749633789
apt1_6,22,1,42,-20,-16.606924057006836,3.393075942993164
apt1_6,22,2,25,-3,-2.88395357131958,0.11604642868041992
apt1_7,23,1,35,-12,-15.053720474243164,3.053720474243164
apt1_7,23,2,20,3,1.2928435802459717,1.7071564197540283
apt1_8,29,1,45,-16,-13.405139923095703,2.594860076904297
apt1_9,22,1,29,-7,-9.795719146728516,2.7957191467285156
apt2_0,32,1,24,8,18.67913818359375,10.67913818359375
apt2_0,32,2,43,-11,-4.368218898773193,6.631781101226807
apt2_0,32,3,39,-7,3.0546998977661133,10.054699897766113
apt2_0,32,4,42,-10,4.411585807800293,14.411585807800293
apt2_0,32,5,46,-14,-5.954685688018799,8.04531478881836
apt2_0,32,6,40,-8,3.741138219833374,11.741138458251953
apt2_0,32,7,44,-12,-6.604004383087158,5.395995616912842
apt2_1,21,1,32,-11,-9.91935920715332,1.0806407928466797
apt2_2,25,1,5,20,17.437925338745117,2.562074661254883
apt2_3,27,1,8,19,20.239274978637695,1.2392749786376953
apt2_4,23,1,46,-23,-18.122636795043945,4.877363204956055
apt2_4,23,2,28,-5,-2.2084145545959473,2.7915854454040527
apt2_5,26,1,15,11,15.315186500549316,4.315186500549316
apt2_5,26,2,30,-4,5.1262288093566895,9.126228332519531
apt2_5,26,3,35,-9,3.7563302516937256,12.756330490112305
apt2_5,26,4,39,-13,-18.855554580688477,5.855554580688477
apt2_5,26,5,20,6,9.73315143585205,3.733151435852051
apt2_5,26,6,30,-4,-10.122363090515137,6.122363090515137
apt2_5,26,7,20,6,9.735922813415527,3.7359228134155273
apt2_6,25,1,33,-8,-4.57617712020874,3.4238228797912598
apt2_6,25,2,28,-3,1.9166287183761597,4.916628837585449
apt2_6,25,3,30,-5,4.7093119621276855,9.709312438964844
apt2_6,25,4,35,-10,5.192508697509766,15.192508697509766
apt2_6,25,5,40,-15,-11.418867111206055,3.5811328887939453
apt2_6,25,6,29,-4,-1.3726357221603394,2.627364158630371
apt2_7,26,1,6,20,34.73457717895508,14.734577178955078
apt2_7,26,2,41,-15,-10.716978073120117,4.283021926879883
apt2_7,26,3,30,-4,4.283987522125244,8.283987045288086
apt2_7,26,4,34,-8,-1.7227743864059448,6.277225494384766
apt2_7,26,5,32,-6,4.474874973297119,10.474874496459961
apt2_7,26,6,36,-10,-4.641693592071533,5.358306407928467
apt2_7,26,7,31,-5,2.0319886207580566,7.031988620758057
apt2_8,30,1,32,-2,0.7909778952598572,2.790977954864502
apt2_9,23,1,21,2,8.224751472473145,6.2247514724731445
apt2_9,23,2,29,-6,-0.6552271246910095,5.344772815704346
apt2_9,23,3,28,-5,-1.7512621879577637,3.2487378120422363
apt2_9,23,4,26,-3,2.446383237838745,5.446383476257324
apt2_9,23,5,28,-5,2.0319583415985107,7.03195858001709
apt2_9,23,6,30,-7,-6.062930583953857,0.9370694160461426
books_0,25,1,12,13,18.323087692260742,5.323087692260742
books_0,25,2,30,-5,8.792243957519531,13.792243957519531
books_0,25,3,39,-14,18.140668869018555,32.14067077636719
books_0,25,4,48,-23,-20.4086971282959,2.5913028717041016
books_1,25,1,30,-5,-0.13472335040569305,4.86527681350708
books_1,25,2,30,-5,1.148838758468628,6.148838996887207
books_1,25,3,31,-6,-2.7198543548583984,3.2801456451416016
books_1,25,4,28,-3,-1.833378553390503,1.166621446609497
books_2,21,1,14,7,6.205118656158447,0.7948813438415527
books_3,23,1,18,5,16.076683044433594,11.076683044433594
books_3,23,2,34,-11,-10.391770362854004,0.6082296371459961
books_4,24,1,31,-7,-0.10155808180570602,6.898441791534424
books_4,24,2,31,-7,2.870995044708252,9.870994567871094
books_4,24,3,34,-10,-12.70085334777832,2.7008533477783203
books_5,21,1,41,-20,-20.84804916381836,0.8480491638183594
books_6,20,1,26,-6,-9.077332496643066,3.0773324966430664
books_6,20,2,17,3,4.095882415771484,1.0958824157714844
books_7,46,1,45,1,14.378414154052734,13.378414154052734
books_7,46,2,48,-2,14.304771423339844,16.304771423339844
books_7,46,3,48,-2,21.84170913696289,23.84170913696289
books_7,46,4,48,-2,16.619749069213867,18.619749069213867
books_7,46,5,48,-2,8.635462760925293,10.635462760925293
books_7,46,6,48,-2,11.711882591247559,13.711882591247559
books_7,46,7,48,-2,13.818497657775879,15.818497657775879
books_8,25,1,9,16,20.19622802734375,4.19622802734375
books_8,25,2,29,-4,19.036251068115234,23.036251068115234
books_8,25,3,48,-23,-6.270493030548096,16.729507446289062
books_8,25,4,42,-17,-4.394490718841553,12.605508804321289
books_8,25,5,38,-13,7.5299482345581055,20.529949188232422
books_8,25,6,46,-21,-5.561339378356934,15.438660621643066
books_8,25,7,40,-15,6.419427394866943,21.4194278717041
books_9,31,1,36,-5,-0.7460166811943054,4.253983497619629
books_9,31,2,35,-4,0.9081782102584839,4.908178329467773
books_9,31,3,36,-5,0.33893969655036926,5.338939666748047
books_9,31,4,36,-5,-3.5369725227355957,1.4630274772644043
bottles_0,22,1,2,20,24.7440242767334,4.744024276733398
bottles_0,22,2,27,-5,-11.529343605041504,6.529343605041504
bottles_0,22,3,15,7,10.524079322814941,3.5240793228149414
bottles_0,22,4,26,-4,-6.931697368621826,2.931697368621826
bottles_1,22,1,25,-3,-5.999147891998291,2.999147891998291
bottles_2,23,1,16,7,15.089681625366211,8.089681625366211
bottles_2,23,2,31,-8,-6.01060676574707,1.9893932342529297
bottles_3,29,1,36,-7,-18.869609832763672,11.869609832763672
bottles_3,29,2,17,12,-18.73985481262207,30.73985481262207
bottles_3,29,3,0,29,-12.719202041625977,41.719200134277344
bottles_3,29,4,0,29,-9.425287246704102,38.42528533935547
bottles_3,29,5,0,29,-4.0235748291015625,33.02357482910156
bottles_3,29,6,0,29,-12.353557586669922,41.35355758666992
bottles_3,29,7,0,29,-13.235567092895508,42.235565185546875
bottles_4,26,1,22,4,21.850643157958984,17.850643157958984
bottles_4,26,2,44,-18,2.397588014602661,20.3975887298584
bottles_4,26,3,46,-20,-7.153345584869385,12.846654891967773
bottles_4,26,4,39,-13,0.6482704281806946,13.648270606994629
bottles_4,26,5,40,-14,3.650282621383667,17.65028190612793
bottles_4,26,6,44,-18,17.377639770507812,35.37763977050781
bottles_4,26,7,48,-22,6.61232852935791,28.612327575683594
bottles_5,26,1,25,1,4.729754447937012,3.7297544479370117
bottles_5,26,2,30,-4,1.841830849647522,5.841830730438232
bottles_5,26,3,32,-6,0.1912032663822174,6.1912031173706055
bottles_5,26,4,32,-6,-0.06328234821557999,5.936717510223389
bottles_5,26,5,32,-6,-3.031136989593506,2.968863010406494
bottles_6,40,1,3,37,22.982412338256836,14.017587661743164
bottles_6,40,2,26,14,24.037425994873047,10.037425994873047
bottles_6,40,3,48,-8,6.132920742034912,14.13292121887207
bottles_6,40,4,48,-8,0.7736499309539795,8.773650169372559
bottles_6,40,5,48,-8,2.143517255783081,10.14351749420166
bottles_6,40,6,48,-8,-2.6182045936584473,5.381795406341553
bottles_6,40,7,45,-5,3.9001832008361816,8.900182723999023
bottles_7,26,1,3,23,25.96609878540039,2.9660987854003906
bottles_8,27,1,43,-16,-15.85580825805664,0.14419174194335938
bottles_9,42,1,25,17,12.021612167358398,4.978387832641602
bottles_9,42,2,37,5,8.337359428405762,3.3373594284057617
bottles_9,42,3,45,-3,0.21849144995212555,3.218491554260254
bottles_9,42,4,45,-3,-10.222240447998047,7.222240447998047
bottles_9,42,5,35,7,8.777117729187012,1.7771177291870117
campusoutdoors1_0,20,1,31,-11,-9.474882125854492,1.5251178741455078
campusoutdoors1_1,20,1,14,6,6.65273904800415,0.6527390480041504
campusoutdoors1_2,21,1,24,-3,8.776823043823242,11.776823043823242
campusoutdoors1_2,21,2,33,-12,1.0198752880096436,13.019875526428223
campusoutdoors1_2,21,3,34,-13,-6.299691677093506,6.700308322906494
campusoutdoors1_2,21,4,28,-7,-8.53300666809082,1.5330066680908203
campusoutdoors1_3,20,1,18,2,6.6854119300842285,4.6854119300842285
campusoutdoors1_3,20,2,25,-5,-2.0322940349578857,2.9677059650421143
campusoutdoors1_4,22,1,19,3,6.468437671661377,3.468437671661377
campusoutdoors1_4,22,2,25,-3,-6.881150722503662,3.881150722503662
campusoutdoors1_4,22,3,18,4,3.336484432220459,0.663515567779541
campusoutdoors1_5,22,1,12,10,0.02776118367910385,9.972238540649414
campusoutdoors1_5,22,2,12,10,5.663968086242676,4.336031913757324
campusoutdoors1_5,22,3,18,4,-1.422706127166748,5.422706127166748
campusoutdoors1_5,22,4,17,5,1.2376320362091064,3.7623679637908936
campusoutdoors1_5,22,5,18,4,3.6967666149139404,0.30323338508605957
campusoutdoors1_6,22,1,2,20,30.778562545776367,10.778562545776367
campusoutdoors1_6,22,2,33,-11,-1.5870168209075928,9.412982940673828
campusoutdoors1_6,22,3,31,-9,-2.5770416259765625,6.4229583740234375
campusoutdoors1_6,22,4,28,-6,-0.3515245020389557,5.648475646972656
campusoutdoors1_6,22,5,28,-6,7.364305019378662,13.36430549621582
campusoutdoors1_6,22,6,35,-13,-6.878767967224121,6.121232032775879
campusoutdoors1_6,22,7,28,-6,5.957725524902344,11.957725524902344
campusoutdoors1_7,47,1,27,20,14.602726936340332,5.397273063659668
campusoutdoors1_7,47,2,42,5,2.030454635620117,2.969545364379883
campusoutdoors1_8,19,1,16,3,0.6657254695892334,2.3342745304107666
campusoutdoors1_9,19,1,46,-27,-24.352121353149414,2.647878646850586
campusoutdoors2_0,20,1,34,-14,-16.701370239257812,2.7013702392578125
campusoutdoors2_1,36,1,32,4,1.346854329109192,2.6531457901000977
campusoutdoors2_3,27,1,7,20,21.490198135375977,1.4901981353759766
campusoutdoors2_4,27,1,18,9,13.743380546569824,4.743380546569824
campusoutdoors2_4,27,2,32,-5,1.849188208580017,6.849188327789307
campusoutdoors2_4,27,3,34,-7,-10.20357608795166,3.20357608795166
campusoutdoors2_4,27,4,24,3,6.572144985198975,3.5721449851989746
campusoutdoors2_4,27,5,31,-4,-2.19283390045166,1.8071660995483398
campusoutdoors2_5,30,1,36,-6,0.6887698173522949,6.688769817352295
campusoutdoors2_5,30,2,37,-7,-1.8776310682296753,5.122368812561035
campusoutdoors2_5,30,3,35,-5,-2.316767454147339,2.683232545852661
campusoutdoors2_6,22,1,16,6,10.786555290222168,4.786555290222168
campusoutdoors2_6,22,2,27,-5,-7.834997653961182,2.8349976539611816
campusoutdoors2_7,23,1,47,-24,-27.05530548095703,3.0553054809570312
campusoutdoors2_7,23,2,20,3,7.986175060272217,4.986175060272217
campusoutdoors2_7,23,3,28,-5,-8.48270034790039,3.4827003479003906
campusoutdoors2_7,23,4,20,3,-5.106612205505371,8.106612205505371
campusoutdoors2_7,23,5,15,8,12.761592864990234,4.761592864990234
campusoutdoors2_7,23,6,28,-5,-2.8217251300811768,2.1782748699188232
campusoutdoors2_8,23,1,29,-6,-25.036680221557617,19.036680221557617
campusoutdoors2_8,23,2,4,19,12.6582670211792,6.341732978820801
campusoutdoors2_8,23,3,17,6,-14.621291160583496,20.621292114257812
campusoutdoors2_8,23,4,2,21,17.454463958740234,3.5455360412597656
campusoutdoors2_8,23,5,19,4,-10.328807830810547,14.328807830810547
campusoutdoors2_8,23,6,9,14,5.565598964691162,8.43440055847168
campusoutdoors2_8,23,7,15,8,-3.4348552227020264,11.434855461120605
campusoutdoors2_9,24,1,32,-8,-4.766039848327637,3.2339601516723633
campusoutdoors2_9,24,2,27,-3,-0.31334778666496277,2.686652183532715
fakeplants_0,23,1,9,14,10.880077362060547,3.119922637939453
fakeplants_0,23,2,20,3,3.818988800048828,0.8189888000488281
fakeplants_1,22,1,5,17,23.289216995239258,6.289216995239258
fakeplants_1,22,2,28,-6,-3.0244853496551514,2.9755146503448486
fakeplants_2,21,1,19,2,3.809926748275757,1.8099267482757568
fakeplants_3,27,1,35,-8,-8.710721015930176,0.7107210159301758
fakeplants_4,24,1,28,-4,-0.874372124671936,3.1256279945373535
fakeplants_4,24,2,27,-3,1.8707895278930664,4.870789527893066
fakeplants_4,24,3,29,-5,-4.15508508682251,0.8449149131774902
fakeplants_5,21,1,36,-15,-10.231287956237793,4.768712043762207
fakeplants_5,21,2,26,-5,-5.270108699798584,0.270108699798584
fakeplants_6,21,1,47,-26,-19.792917251586914,6.207082748413086
fakeplants_6,21,2,27,-6,2.0356292724609375,8.035629272460938
fakeplants_6,21,3,29,-8,-11.328019142150879,3.328019142150879
fakeplants_6,21,4,18,3,6.238099575042725,3.2380995750427246
fakeplants_6,21,5,24,-3,1.0033513307571411,4.003351211547852
fakeplants_6,21,6,25,-4,1.0095103979110718,5.009510517120361
fakeplants_6,21,7,26,-5,-0.03313301503658295,4.966866970062256
fakeplants_7,22,1,16,6,16.80404281616211,10.80404281616211
fakeplants_7,22,2,33,-11,-7.097332954406738,3.9026670455932617
fakeplants_7,22,3,26,-4,2.2034661769866943,6.203466415405273
fakeplants_7,22,4,28,-6,-11.617202758789062,5.6172027587890625
fakeplants_7,22,5,16,6,14.346929550170898,8.346929550170898
fakeplants_7,22,6,30,-8,-8.836374282836914,0.8363742828369141
fakeplants_8,22,1,44,-22,-13.586343765258789,8.413656234741211
fakeplants_8,22,2,30,-8,-3.0039048194885254,4.996095180511475
fakeplants_8,22,3,27,-5,8.423624038696289,13.423624038696289
fakeplants_8,22,4,35,-13,-19.256019592285156,6.256019592285156
fakeplants_8,22,5,16,6,8.282743453979492,2.282743453979492
fakeplants_9,21,1,40,-19,-20.120386123657227,1.1203861236572266
garage2_0,22,1,13,9,16.127689361572266,7.127689361572266
garage2_0,22,2,29,-7,-12.1167631149292,5.116763114929199
garage2_0,22,3,17,5,5.000701427459717,0.0007014274597167969
garage2_1,25,1,30,-5,2.2317490577697754,7.231749057769775
garage2_1,25,2,32,-7,-1.4305500984191895,5.5694499015808105
garage2_1,25,3,31,-6,-0.022660573944449425,5.977339267730713
garage2_1,25,4,31,-6,-0.9108187556266785,5.089181423187256
garage2_1,25,5,30,-5,-1.7913649082183838,3.208635091781616
garage2_1,25,6,28,-3,0.1193755716085434,3.119375467300415
garage2_1,25,7,28,-3,4.901382923126221,7.901382923126221
garage2_2,31,1,8,23,26.936235427856445,3.9362354278564453
garage2_2,31,2,35,-4,1.681396245956421,5.681396484375
garage2_2,31,3,37,-6,-0.5171362161636353,5.482863903045654
garage2_2,31,4,36,-5,2.339055061340332,7.339055061340332
garage2_2,31,5,38,-7,-3.8577466011047363,3.1422533988952637
garage2_2,31,6,34,-3,3.2433114051818848,6.243311405181885
garage2_2,31,7,37,-6,-0.5230120420455933,5.476987838745117
garage2_3,38,1,48,-10,23.79517364501953,33.79517364501953
garage2_3,38,2,48,-10,19.830577850341797,29.830577850341797
garage2_3,38,3,48,-10,20.802169799804688,30.802169799804688
garage2_3,38,4,48,-10,22.696269989013672,32.69626998901367
garage2_3,38,5,48,-10,18.880779266357422,28.880779266357422
garage2_3,38,6,48,-10,24.86121940612793,34.86122131347656
garage2_3,38,7,48,-10,18.364013671875,28.364013671875
garage2_4,26,1,15,11,27.243568420410156,16.243568420410156
garage2_4,26,2,42,-16,-18.666667938232422,2.666667938232422
garage2_5,36,1,6,30,23.5203800201416,6.479619979858398
garage2_5,36,2,30,6,16.754552841186523,10.754552841186523
garage2_5,36,3,47,-11,-11.312177658081055,0.3121776580810547
garage2_6,25,1,3,22,30.12339973449707,8.12339973449707
garage2_6,25,2,33,-8,-11.46468734741211,3.4646873474121094
garage2_6,25,3,22,3,9.776485443115234,6.776485443115234
garage2_6,25,4,32,-7,-6.879311561584473,0.12068843841552734
garage2_7,21,1,35,-14,-1.6276178359985352,12.372382164001465
garage2_7,21,2,33,-12,-9.969486236572266,2.0305137634277344
garage2_8,22,1,32,-10,-6.677794456481934,3.3222055435180664
garage2_8,22,2,25,-3,-5.73572301864624,2.7357230186462402
garage2_9,23,1,7,16,20.91403579711914,4.914035797119141
garage2_9,23,2,28,-5,-9.27465534210205,4.274655342102051
garage2_9,23,3,19,4,-5.587941646575928,9.587942123413086
garage2_9,23,4,13,10,10.520626068115234,0.5206260681152344
garage_0,25,1,42,-17,-18.33584976196289,1.3358497619628906
garage_1,23,1,19,4,2.5909855365753174,1.4090144634246826
garage_2,36,1,8,28,24.957048416137695,3.0429515838623047
garage_2,36,2,33,3,5.521204471588135,2.5212044715881348
garage_3,21,1,6,15,13.511712074279785,1.4882879257202148
garage_4,36,1,11,25,6.928327560424805,18.071672439575195
garage_4,36,2,18,18,17.077392578125,0.922607421875
garage_6,26,1,22,4,11.644115447998047,7.644115447998047
garage_6,26,2,34,-8,-5.897877216339111,2.1021227836608887
garage_7,22,1,15,7,7.83036994934082,0.8303699493408203
garage_8,37,1,13,24,32.098548889160156,8.098548889160156
garage_8,37,2,45,-8,-6.64094352722168,1.3590564727783203
garage_9,20,1,33,-13,-0.2044840306043625,12.795516014099121
garage_9,20,2,33,-13,-1.64011812210083,11.359882354736328
garage_9,20,3,31,-11,-11.329842567443848,0.32984256744384766
hallway1_0,28,1,39,-11,-7.156023979187012,3.8439760208129883
hallway1_0,28,2,32,-4,5.407017230987549,9.40701675415039
hallway1_0,28,3,37,-9,3.459446907043457,12.459446907043457
hallway1_0,28,4,40,-12,-3.4759182929992676,8.52408218383789
hallway1_0,28,5,37,-9,1.4940104484558105,10.494010925292969
hallway1_0,28,6,38,-10,-3.7105000019073486,6.2895002365112305
hallway1_0,28,7,34,-6,1.7976595163345337,7.797659397125244
hallway1_2,31,1,37,-6,11.325679779052734,17.325679779052734
hallway1_2,31,2,48,-17,1.0756464004516602,18.075645446777344
hallway1_2,31,3,48,-17,2.5979347229003906,19.59793472290039
hallway1_2,31,4,48,-17,-0.36616864800453186,16.633831024169922
hallway1_2,31,5,48,-17,-2.3373324871063232,14.662667274475098
hallway1_2,31,6,46,-15,2.469125747680664,17.469125747680664
hallway1_2,31,7,48,-17,-3.101719379425049,13.89828109741211
hallway1_3,25,1,37,-12,4.2292704582214355,16.229270935058594
hallway1_3,25,2,41,-16,-3.9880685806274414,12.011931419372559
hallway1_3,25,3,37,-12,-5.890669822692871,6.109330177307129
hallway1_3,25,4,31,-6,10.164175033569336,16.164175033569336
hallway1_3,25,5,41,-16,6.054299354553223,22.054298400878906
hallway1_3,25,6,47,-22,2.4387974739074707,24.438796997070312
hallway1_3,25,7,48,-23,-16.52381134033203,6.476188659667969
hallway1_4,28,1,6,22,24.892375946044922,2.892375946044922
hallway1_5,22,1,41,-19,-14.752899169921875,4.247100830078125
hallway1_5,22,2,26,-4,3.9662201404571533,7.966219902038574
hallway1_5,22,3,30,-8,-6.771000862121582,1.228999137878418
hallway1_6,25,1,32,-7,-5.287846088409424,1.7121539115905762
hallway1_7,33,1,18,15,25.806293487548828,10.806293487548828
hallway1_7,33,2,44,-11,11.842450141906738,22.842449188232422
hallway1_7,33,3,48,-15,0.9191930294036865,15.919193267822266
hallway1_7,33,4,48,-15,-3.2326226234436035,11.767377853393555
hallway1_7,33,5,45,-12,-2.0959246158599854,9.904075622558594
hallway1_7,33,6,43,-10,-5.281598091125488,4.718401908874512
hallway1_7,33,7,38,-5,2.3491110801696777,7.349111080169678
hallway1_8,42,1,37,5,10.449132919311523,5.449132919311523
hallway1_8,42,2,47,-5,0.6202289462089539,5.6202287673950195
hallway1_8,42,3,48,-6,0.772210955619812,6.772211074829102
hallway1_8,42,4,48,-6,-4.975458145141602,1.0245418548583984
hallway1_9,37,1,43,-6,6.035341262817383,12.035341262817383
hallway1_9,37,2,48,-11,-8.77968692779541,2.22031307220459
hallway2_0,27,1,45,-18,-17.308130264282227,0.6918697357177734
hallway2_1,28,1,21,7,28.792362213134766,21.792362213134766
hallway2_1,28,2,48,-20,17.8083553314209,37.80835723876953
hallway2_1,28,3,48,-20,19.686450958251953,39.68645095825195
hallway2_1,28,4,48,-20,16.970134735107422,36.97013473510742
hallway2_1,28,5,48,-20,14.95742130279541,34.957420349121094
hallway2_1,28,6,48,-20,19.702566146850586,39.70256805419922
hallway2_1,28,7,48,-20,17.835859298706055,37.83586120605469
hallway2_2,26,1,16,10,15.36303424835205,5.363034248352051
hallway2_2,26,2,31,-5,3.660329580307007,8.660329818725586
hallway2_2,26,3,35,-9,-4.6274261474609375,4.3725738525390625
hallway2_2,26,4,30,-4,-1.1418473720550537,2.8581526279449463
