filename,CorrectPosition,focus_time,index,label,pred,loss
home1_0,29,1,48,-19,1.618757724761963,20.618757247924805
home1_0,29,2,48,-19,-12.065690994262695,6.934309005737305
home1_0,29,3,36,-7,-4.761602401733398,2.2383975982666016
home1_1,23,1,43,-20,-13.659270286560059,6.340729713439941
home1_1,23,2,29,-6,-14.57168197631836,8.57168197631836
home1_1,23,3,14,9,5.267321586608887,3.7326784133911133
home1_2,37,1,48,-11,-3.407057285308838,7.592942714691162
home1_2,37,2,45,-8,-7.3284430503845215,0.6715569496154785
home1_3,32,1,48,-16,-7.158028602600098,8.841971397399902
home1_3,32,2,41,-9,-5.604257583618164,3.395742416381836
home1_4,47,1,48,-1,-9.855412483215332,8.855412483215332
home1_4,47,2,38,9,-1.0435396432876587,10.043540000915527
home1_4,47,3,37,10,4.175558090209961,5.824441909790039
home1_4,47,4,41,6,-0.9810141324996948,6.981014251708984
home1_4,47,5,40,7,6.265120506286621,0.7348794937133789
home1_5,47,1,48,-1,-2.785691261291504,1.785691261291504
home1_6,34,1,48,-14,-9.434813499450684,4.565186500549316
home1_8,29,1,48,-19,-2.4008889198303223,16.599111557006836
home1_8,29,2,46,-17,-6.316756248474121,10.683243751525879
home1_8,29,3,40,-11,-6.556685924530029,4.443314075469971
home1_9,26,1,46,-20,-11.705737113952637,8.294262886047363
home1_9,26,2,34,-8,-7.284224510192871,0.7157754898071289
home2_0,38,1,48,-10,-3.8260512351989746,6.173948764801025
home2_0,38,2,44,-6,-4.498307228088379,1.501692771911621
home2_2,43,1,48,-5,3.5425593852996826,8.542559623718262
home2_2,43,2,48,-5,-3.0104939937591553,1.9895060062408447
home2_3,31,1,48,-17,0.6848703622817993,17.68486976623535
home2_3,31,2,48,-17,7.503464221954346,24.503463745117188
home2_3,31,3,48,-17,-1.9344456195831299,15.06555461883545
home2_3,31,4,46,-15,5.5381669998168945,20.538166046142578
home2_3,31,5,48,-17,0.7875243425369263,17.787525177001953
home2_3,31,6,48,-17,0.28470703959465027,17.284706115722656
home2_3,31,7,48,-17,4.927500247955322,21.927499771118164
home2_4,34,1,48,-14,-2.670534133911133,11.329465866088867
home2_4,34,2,45,-11,4.142698287963867,15.142698287963867
home2_4,34,3,48,-14,-3.238180637359619,10.761819839477539
home2_4,34,4,45,-11,1.857311487197876,12.857311248779297
home2_4,34,5,47,-13,4.149988651275635,17.149988174438477
home2_4,34,6,48,-14,0.8333149552345276,14.833314895629883
home2_4,34,7,48,-14,1.6196831464767456,15.619683265686035
home2_5,30,1,48,-18,-1.7619010210037231,16.23809814453125
home2_5,30,2,46,-16,1.9247541427612305,17.924755096435547
home2_5,30,3,48,-18,-0.9185503125190735,17.081449508666992
home2_5,30,4,47,-17,-2.57277512550354,14.427225112915039
home2_5,30,5,44,-14,-1.4999810457229614,12.500019073486328
home2_5,30,6,43,-13,-2.5341882705688477,10.465811729431152
home2_5,30,7,40,-10,-1.6345289945602417,8.365470886230469
home2_6,29,1,48,-19,4.578597068786621,23.578598022460938
home2_6,29,2,48,-19,-0.526649534702301,18.473350524902344
home2_6,29,3,47,-18,-3.021170139312744,14.978830337524414
home2_6,29,4,44,-15,2.07076358795166,17.070762634277344
home2_6,29,5,46,-17,-0.6487846970558167,16.351215362548828
home2_6,29,6,45,-16,-0.6530556082725525,15.346944808959961
home2_6,29,7,44,-15,2.336883783340454,17.336883544921875
home2_7,34,1,48,-14,3.4944610595703125,17.494461059570312
home2_7,34,2,48,-14,2.966978073120117,16.966978073120117
home2_7,34,3,48,-14,2.714151382446289,16.71415138244629
home2_7,34,4,48,-14,2.857966423034668,16.857967376708984
home2_7,34,5,48,-14,2.653968572616577,16.653968811035156
home2_7,34,6,48,-14,2.8691437244415283,16.869144439697266
home2_7,34,7,48,-14,1.879282832145691,15.87928295135498
home2_9,30,1,48,-18,-14.525466918945312,3.4745330810546875
microkitchen1_0,21,1,41,-20,-12.385354995727539,7.614645004272461
microkitchen1_0,21,2,29,-8,-2.5587284564971924,5.441271781921387
microkitchen1_0,21,3,26,-5,-1.4924914836883545,3.5075085163116455
microkitchen1_1,21,1,41,-20,-38.85723114013672,18.85723114013672
microkitchen1_1,21,2,2,19,18.448827743530273,0.5511722564697266
microkitchen1_2,21,1,41,-20,-20.70147705078125,0.70147705078125
microkitchen1_3,24,1,44,-20,-15.50531005859375,4.49468994140625
microkitchen1_4,25,1,45,-20,-17.722089767456055,2.2779102325439453
microkitchen1_5,25,1,45,-20,-7.56150484085083,12.438495635986328
microkitchen1_5,25,2,37,-12,-7.814243793487549,4.185756206512451
microkitchen1_6,25,1,45,-20,-10.381547927856445,9.618452072143555
microkitchen1_6,25,2,35,-10,-8.0253267288208,1.9746732711791992
microkitchen1_7,20,1,40,-20,-6.619578838348389,13.380420684814453
microkitchen1_7,20,2,33,-13,-10.19945240020752,2.8005475997924805
microkitchen1_8,29,1,48,-19,-22.729475021362305,3.7294750213623047
microkitchen1_9,19,1,39,-20,-21.812450408935547,1.8124504089355469
pillowroom1_0,25,1,45,-20,-2.771967887878418,17.228031158447266
pillowroom1_0,25,2,42,-17,1.0320534706115723,18.032052993774414
pillowroom1_0,25,3,43,-18,5.077305316925049,23.07730484008789
pillowroom1_0,25,4,48,-23,-3.408996105194092,19.59100341796875
pillowroom1_0,25,5,45,-20,-6.8259077072143555,13.174092292785645
pillowroom1_0,25,6,38,-13,4.026820182800293,17.02682113647461
pillowroom1_0,25,7,42,-17,0.3165249824523926,17.316524505615234
pillowroom1_6,27,1,47,-20,-9.135533332824707,10.864466667175293
pillowroom1_6,27,2,38,-11,-4.761480331420898,6.238519668579102
pillowroom1_6,27,3,33,-6,4.899275779724121,10.899275779724121
pillowroom1_6,27,4,38,-11,-4.304253578186035,6.695746421813965
pillowroom1_6,27,5,34,-7,1.6096396446228027,8.609640121459961
pillowroom1_6,27,6,36,-9,-2.583742141723633,6.416257858276367
pillowroom1_6,27,7,33,-6,2.859651565551758,8.859651565551758
pillowroom1_7,36,1,48,-12,4.125857353210449,16.125858306884766
pillowroom1_7,36,2,48,-12,2.276956081390381,14.276956558227539
pillowroom1_7,36,3,48,-12,-13.864152908325195,1.8641529083251953
pillowroom1_8,34,1,48,-14,5.750674724578857,19.750675201416016
pillowroom1_8,34,2,48,-14,1.7788331508636475,15.778833389282227
pillowroom1_8,34,3,48,-14,-4.948212623596191,9.051787376403809
pillowroom1_8,34,4,43,-9,-0.4555699825286865,8.544429779052734
pillowroom1_8,34,5,43,-9,3.1638269424438477,12.163826942443848
pillowroom1_8,34,6,46,-12,-2.4208829402923584,9.579116821289062
pillowroom1_8,34,7,44,-10,-8.397880554199219,1.6021194458007812
pillowroom1_9,21,1,41,-20,6.638319492340088,26.63831901550293
pillowroom1_9,21,2,48,-27,-4.148996353149414,22.851003646850586
pillowroom1_9,21,3,44,-23,2.4873650074005127,25.48736572265625
pillowroom1_9,21,4,46,-25,-1.868337869644165,23.131662368774414
pillowroom1_9,21,5,44,-23,-4.693965435028076,18.306034088134766
pillowroom1_9,21,6,39,-18,-5.095431804656982,12.90456771850586
pillowroom1_9,21,7,34,-13,-5.00426721572876,7.99573278427124
secondfloorgames_0,20,1,40,-20,-11.717329025268555,8.282670974731445
secondfloorgames_0,20,2,28,-8,-8.082303047180176,0.08230304718017578
secondfloorgames_1,24,1,44,-20,12.551982879638672,32.55198287963867
secondfloorgames_1,24,2,48,-24,1.966660499572754,25.966659545898438
secondfloorgames_1,24,3,48,-24,21.378679275512695,45.37867736816406
secondfloorgames_1,24,4,48,-24,5.261562347412109,29.26156234741211
secondfloorgames_1,24,5,48,-24,15.540112495422363,39.54011154174805
secondfloorgames_1,24,6,48,-24,5.728799819946289,29.72879981994629
secondfloorgames_1,24,7,48,-24,9.108643531799316,33.108642578125
secondfloorgames_2,30,1,48,-18,-16.53304672241211,1.4669532775878906
secondfloorgames_3,23,1,43,-20,-12.118525505065918,7.881474494934082
secondfloorgames_3,23,2,31,-8,-2.4648566246032715,5.5351433753967285
secondfloorgames_3,23,3,29,-6,-3.809079885482788,2.190920114517212
secondfloorgames_4,22,1,42,-20,-23.054271697998047,3.054271697998047
secondfloorgames_5,24,1,44,-20,-16.65326499938965,3.3467350006103516
secondfloorgames_6,19,1,39,-20,-24.794557571411133,4.794557571411133
secondfloorgames_7,20,1,40,-20,-13.187201499938965,6.812798500061035
secondfloorgames_7,20,2,27,-7,2.0217435359954834,9.021743774414062
secondfloorgames_7,20,3,29,-9,-10.031763076782227,1.0317630767822266
secondfloorgames_8,23,1,43,-20,-6.886691570281982,13.11330795288086
secondfloorgames_8,23,2,36,-13,1.8728253841400146,14.872825622558594
secondfloorgames_8,23,3,38,-15,-7.3291425704956055,7.6708574295043945
secondfloorgames_8,23,4,31,-8,-7.279356479644775,0.7206435203552246
apt1_0,25,1,45,-20,-14.067662239074707,5.932337760925293
apt1_0,25,2,31,-6,-11.443593978881836,5.443593978881836
apt1_0,25,3,20,5,-4.2846574783325195,9.28465747833252
apt1_0,25,4,16,9,8.240644454956055,0.7593555450439453
apt1_1,21,1,41,-20,-25.369640350341797,5.369640350341797
apt1_1,21,2,16,5,-4.438750743865967,9.438751220703125
apt1_1,21,3,12,9,4.425529956817627,4.574470043182373
apt1_2,24,1,44,-20,-14.441474914550781,5.558525085449219
apt1_2,24,2,30,-6,-9.14490795135498,3.1449079513549805
apt1_3,25,1,45,-20,-9.668336868286133,10.331663131713867
apt1_3,25,2,35,-10,-12.280413627624512,2.2804136276245117
apt1_4,23,1,43,-20,5.05670690536499,25.05670738220215
apt1_4,23,2,48,-25,4.520627498626709,29.520627975463867
apt1_4,23,3,48,-25,4.94545316696167,29.945453643798828
apt1_4,23,4,48,-25,3.581435203552246,28.581436157226562
apt1_4,23,5,48,-25,2.1919021606445312,27.19190216064453
apt1_4,23,6,48,-25,1.5780551433563232,26.578054428100586
apt1_4,23,7,48,-25,2.7492499351501465,27.749250411987305
apt1_5,22,1,42,-20,2.2774672508239746,22.277467727661133
apt1_5,22,2,44,-22,5.465485572814941,27.465484619140625
apt1_5,22,3,48,-26,1.6356990337371826,27.635698318481445
apt1_5,22,4,48,-26,2.851853609085083,28.85185432434082
apt1_5,22,5,48,-26,7.004204750061035,33.00420379638672
apt1_5,22,6,48,-26,2.525831460952759,28.52583122253418
apt1_5,22,7,48,-26,-3.898421287536621,22.101577758789062
apt1_6,20,1,40,-20,-17.400737762451172,2.599262237548828
apt1_7,20,1,40,-20,-22.604249954223633,2.604249954223633
apt1_8,31,1,48,-17,15.4188871383667,32.418888092041016
apt1_8,31,2,48,-17,-12.241425514221191,4.758574485778809
apt1_9,20,1,40,-20,-21.33294677734375,1.33294677734375
apt2_0,41,1,48,-7,-1.5717295408248901,5.42827033996582
apt2_0,41,2,46,-5,-2.5694797039031982,2.4305202960968018
apt2_1,20,1,40,-20,2.579160213470459,22.579160690307617
apt2_1,20,2,43,-23,8.236471176147461,31.23647117614746
apt2_1,20,3,48,-28,10.810737609863281,38.81073760986328
apt2_1,20,4,48,-28,6.683391571044922,34.68339157104492
apt2_1,20,5,48,-28,-17.538694381713867,10.461305618286133
apt2_1,20,6,30,-10,3.9067904949188232,13.906790733337402
apt2_1,20,7,34,-14,5.616238117218018,19.61623764038086
apt2_2,23,1,43,-20,-8.643498420715332,11.356501579284668
apt2_2,23,2,34,-11,12.268250465393066,23.26824951171875
apt2_2,23,3,46,-23,-10.918366432189941,12.081633567810059
apt2_2,23,4,35,-12,-9.54765796661377,2.4523420333862305
apt2_3,26,1,46,-20,12.120499610900879,32.12049865722656
apt2_3,26,2,48,-22,10.801243782043457,32.80124282836914
apt2_3,26,3,48,-22,4.445408344268799,26.44540786743164
apt2_3,26,4,48,-22,-0.2905997633934021,21.709400177001953
apt2_3,26,5,48,-22,14.671757698059082,36.671756744384766
apt2_3,26,6,48,-22,0.9925874471664429,22.99258804321289
apt2_3,26,7,48,-22,-5.0632758140563965,16.936723709106445
apt2_4,23,1,43,-20,-12.053248405456543,7.946751594543457
apt2_4,23,2,31,-8,-7.315117359161377,0.684882640838623
apt2_5,26,1,46,-20,-3.124894857406616,16.875104904174805
apt2_5,26,2,43,-17,-7.715847969055176,9.284152030944824
apt2_5,26,3,35,-9,-1.2407214641571045,7.759278297424316
apt2_5,26,4,34,-8,-2.727935791015625,5.272064208984375
apt2_5,26,5,31,-5,-0.3724856972694397,4.627514362335205
apt2_6,23,1,43,-20,-1.734946608543396,18.265052795410156
apt2_6,23,2,41,-18,-4.708380699157715,13.291619300842285
apt2_6,23,3,36,-13,0.41816121339797974,13.418161392211914
apt2_6,23,4,36,-13,5.515591621398926,18.51559066772461
apt2_6,23,5,42,-19,-5.914637565612793,13.085362434387207
apt2_6,23,6,36,-13,-0.9567384123802185,12.043261528015137
apt2_6,23,7,35,-12,-4.206820011138916,7.793179988861084
apt2_7,31,1,48,-17,-19.224925994873047,2.224925994873047
apt2_8,40,1,48,-8,-3.3596813678741455,4.640318870544434
apt2_9,24,1,44,-20,-2.5066983699798584,17.493301391601562
apt2_9,24,2,41,-17,11.946208953857422,28.946208953857422
apt2_9,24,3,48,-24,0.9671405553817749,24.967140197753906
apt2_9,24,4,48,-24,1.9646333456039429,25.96463394165039
apt2_9,24,5,48,-24,9.468378067016602,33.46837615966797
apt2_9,24,6,48,-24,13.478548049926758,37.478546142578125
apt2_9,24,7,48,-24,-4.679618835449219,19.32038116455078
books_0,27,1,47,-20,-11.716588020324707,8.283411979675293
books_0,27,2,35,-8,-7.1898932456970215,0.8101067543029785
books_1,26,1,46,-20,-8.263239860534668,11.736760139465332
books_1,26,2,38,-12,10.761378288269043,22.76137924194336
books_1,26,3,48,-22,-3.88399076461792,18.116008758544922
books_1,26,4,44,-18,7.1297478675842285,25.12974739074707
books_1,26,5,48,-22,0.5942509770393372,22.59425163269043
books_1,26,6,48,-22,-6.612252235412598,15.387747764587402
books_1,26,7,41,-15,1.4063130617141724,16.406312942504883
books_2,22,1,42,-20,-7.095403671264648,12.904596328735352
books_2,22,2,35,-13,-7.45442008972168,5.54557991027832
books_2,22,3,28,-6,-0.6858655214309692,5.31413459777832
books_2,22,4,27,-5,-2.3572983741760254,2.6427016258239746
books_3,23,1,43,-20,-14.217759132385254,5.782240867614746
books_3,23,2,29,-6,-8.506421089172363,2.5064210891723633
books_4,24,1,44,-20,-14.720390319824219,5.279609680175781
books_4,24,2,29,-5,8.13408374786377,13.13408374786377
books_4,24,3,37,-13,-3.607372999191284,9.392626762390137
books_4,24,4,33,-9,-3.3033931255340576,5.696606636047363
books_4,24,5,30,-6,-5.1816325187683105,0.8183674812316895
books_5,22,1,42,-20,-19.761415481567383,0.2385845184326172
books_6,20,1,40,-20,6.786588191986084,26.786588668823242
books_6,20,2,47,-27,11.49232292175293,38.49232482910156
books_6,20,3,48,-28,6.8444132804870605,34.84441375732422
books_6,20,4,48,-28,8.569645881652832,36.569644927978516
books_6,20,5,48,-28,5.700802803039551,33.700801849365234
books_6,20,6,48,-28,10.367310523986816,38.3673095703125
books_6,20,7,48,-28,7.538249492645264,35.53824996948242
books_7,26,1,46,-20,3.389251708984375,23.389251708984375
books_7,26,2,48,-22,4.156493663787842,26.156494140625
books_7,26,3,48,-22,4.519272804260254,26.519271850585938
books_7,26,4,48,-22,4.511227130889893,26.511226654052734
books_7,26,5,48,-22,4.381793975830078,26.381793975830078
books_7,26,6,48,-22,4.88176155090332,26.88176155090332
books_7,26,7,48,-22,3.159153461456299,25.15915298461914
books_8,23,1,43,-20,2.026181697845459,22.026182174682617
books_8,23,2,45,-22,4.312921524047852,26.31292152404785
books_8,23,3,48,-25,5.447818756103516,30.447818756103516
books_8,23,4,48,-25,2.335428237915039,27.33542823791504
books_8,23,5,48,-25,4.729755401611328,29.729755401611328
books_8,23,6,48,-25,6.695632457733154,31.695632934570312
books_8,23,7,48,-25,3.0498077869415283,28.049808502197266
books_9,27,1,47,-20,-14.811417579650879,5.188582420349121
books_9,27,2,32,-5,2.3427677154541016,7.342767715454102
books_9,27,3,34,-7,-1.732507586479187,5.267492294311523
books_9,27,4,32,-5,-2.0250654220581055,2.9749345779418945
bottles_0,22,1,42,-20,-18.398056030273438,1.6019439697265625
bottles_1,23,1,43,-20,-20.531452178955078,0.5314521789550781
bottles_2,22,1,42,-20,-22.296466827392578,2.296466827392578
bottles_3,30,1,48,-18,-7.103528022766113,10.896471977233887
bottles_3,30,2,41,-11,-12.656883239746094,1.6568832397460938
bottles_4,25,1,45,-20,-7.850955009460449,12.14904499053955
bottles_4,25,2,37,-12,-7.995926380157471,4.004073619842529
bottles_5,27,1,47,-20,2.285900354385376,22.285900115966797
bottles_5,27,2,48,-21,-6.599202632904053,14.400796890258789
bottles_5,27,3,41,-14,-5.370017051696777,8.629982948303223
bottles_5,27,4,36,-9,0.2375173419713974,9.237517356872559
bottles_5,27,5,36,-9,-3.1772305965423584,5.8227691650390625
bottles_5,27,6,33,-6,5.000122547149658,11.0001220703125
bottles_5,27,7,38,-11,-2.6586086750030518,8.341391563415527
bottles_6,27,1,47,-20,-7.064209938049316,12.935790061950684
bottles_6,27,2,40,-13,-3.4235823154449463,9.576417922973633
bottles_6,27,3,37,-10,5.3306708335876465,15.330671310424805
bottles_6,27,4,42,-15,-9.346137046813965,5.653862953186035
bottles_6,27,5,33,-6,3.3270225524902344,9.327022552490234
bottles_6,27,6,36,-9,-5.749905109405518,3.2500948905944824
bottles_7,27,1,47,-20,0.19143721461296082,20.191436767578125
bottles_7,27,2,47,-20,-9.389435768127441,10.610564231872559
bottles_7,27,3,38,-11,-9.1705322265625,1.8294677734375
bottles_8,25,1,45,-20,-2.6933512687683105,17.30664825439453
bottles_8,25,2,42,-17,-8.429484367370605,8.570515632629395
bottles_8,25,3,34,-9,-10.28939151763916,1.2893915176391602
campusoutdoors1_0,20,1,40,-20,-24.870689392089844,4.870689392089844
campusoutdoors1_1,20,1,40,-20,-16.708999633789062,3.2910003662109375
campusoutdoors1_2,22,1,42,-20,-16.750263214111328,3.249736785888672
campusoutdoors1_3,20,1,40,-20,-29.558780670166016,9.558780670166016
campusoutdoors1_3,20,2,10,10,0.07130274921655655,9.92869758605957
campusoutdoors1_3,20,3,10,10,-1.4448482990264893,11.44484806060791
campusoutdoors1_3,20,4,9,11,-2.822719097137451,13.82271957397461
campusoutdoors1_3,20,5,6,14,3.608520984649658,10.3914794921875
campusoutdoors1_3,20,6,10,10,2.9635093212127686,7.036490440368652
campusoutdoors1_3,20,7,13,7,-2.2110788822174072,9.211078643798828
campusoutdoors1_4,22,1,42,-20,-13.781303405761719,6.218696594238281
campusoutdoors1_4,22,2,28,-6,-7.430438041687012,1.4304380416870117
campusoutdoors1_5,22,1,42,-20,-11.259153366088867,8.740846633911133
campusoutdoors1_5,22,2,31,-9,-7.5089216232299805,1.4910783767700195
campusoutdoors1_6,27,1,47,-20,-18.411211013793945,1.5887889862060547
campusoutdoors1_8,19,1,39,-20,-9.486818313598633,10.513181686401367
campusoutdoors1_8,19,2,30,-11,7.95410680770874,18.9541072845459
campusoutdoors1_8,19,3,38,-19,-9.556879997253418,9.443120002746582
campusoutdoors1_8,19,4,28,-9,-12.710335731506348,3.7103357315063477
campusoutdoors1_9,19,1,39,-20,15.833395957946777,35.833396911621094
campusoutdoors1_9,19,2,48,-29,-1.2058453559875488,27.79415512084961
campusoutdoors1_9,19,3,47,-28,1.2105811834335327,29.210580825805664
campusoutdoors1_9,19,4,48,-29,22.09766960144043,51.09767150878906
campusoutdoors1_9,19,5,48,-29,12.39827823638916,41.398277282714844
campusoutdoors1_9,19,6,48,-29,-5.76378059387207,23.23621940612793
campusoutdoors1_9,19,7,42,-23,22.488365173339844,45.488365173339844
campusoutdoors2_0,20,1,40,-20,-7.031246662139893,12.968753814697266
campusoutdoors2_0,20,2,33,-13,-7.324545383453369,5.675454616546631
campusoutdoors2_0,20,3,26,-6,-5.743227005004883,0.2567729949951172
campusoutdoors2_1,42,1,48,-6,-10.922992706298828,4.922992706298828
campusoutdoors2_3,31,1,48,-17,-8.644856452941895,8.355143547058105
campusoutdoors2_3,31,2,39,-8,-6.444511890411377,1.555488109588623
campusoutdoors2_4,29,1,48,-19,-9.581734657287598,9.418265342712402
campusoutdoors2_4,29,2,38,-9,-7.930534839630127,1.069465160369873
campusoutdoors2_5,32,1,48,-16,-9.534614562988281,6.465385437011719
campusoutdoors2_5,32,2,38,-6,-12.737833976745605,6.7378339767456055
campusoutdoors2_5,32,3,25,7,-2.7416367530822754,9.741636276245117
campusoutdoors2_5,32,4,22,10,6.75108528137207,3.2489147186279297
campusoutdoors2_6,22,1,42,-20,16.440324783325195,36.44032287597656
campusoutdoors2_6,22,2,48,-26,-7.567984580993652,18.43201446533203
campusoutdoors2_6,22,3,40,-18,13.829009056091309,31.829010009765625
campusoutdoors2_6,22,4,48,-26,3.9874796867370605,29.98748016357422
campusoutdoors2_6,22,5,48,-26,-0.717728316783905,25.282272338867188
campusoutdoors2_6,22,6,47,-25,9.34795093536377,34.34794998168945
campusoutdoors2_6,22,7,48,-26,-1.8995188474655151,24.100481033325195
campusoutdoors2_7,23,1,43,-20,6.300752639770508,26.300752639770508
campusoutdoors2_7,23,2,48,-25,4.069329261779785,29.06932830810547
campusoutdoors2_7,23,3,48,-25,7.944613933563232,32.94461441040039
campusoutdoors2_7,23,4,48,-25,17.428518295288086,42.42852020263672
campusoutdoors2_7,23,5,48,-25,9.005014419555664,34.00501251220703
campusoutdoors2_7,23,6,48,-25,19.14371681213379,44.143714904785156
campusoutdoors2_7,23,7,48,-25,14.438990592956543,39.43899154663086
campusoutdoors2_8,23,1,43,-20,-4.797789096832275,15.202211380004883
campusoutdoors2_8,23,2,38,-15,-1.2351531982421875,13.764846801757812
campusoutdoors2_8,23,3,37,-14,-2.5155065059661865,11.484493255615234
campusoutdoors2_8,23,4,34,-11,-1.4518307447433472,9.548169136047363
campusoutdoors2_8,23,5,33,-10,0.30009764432907104,10.300097465515137
campusoutdoors2_8,23,6,33,-10,0.47639229893684387,10.47639274597168
campusoutdoors2_8,23,7,33,-10,2.9928464889526367,12.992846488952637
campusoutdoors2_9,25,1,45,-20,-0.3559913635253906,19.64400863647461
campusoutdoors2_9,25,2,45,-20,7.023528575897217,27.023529052734375
campusoutdoors2_9,25,3,48,-23,-0.34082120656967163,22.6591796875
campusoutdoors2_9,25,4,48,-23,14.621195793151855,37.62119674682617
campusoutdoors2_9,25,5,48,-23,27.7017879486084,50.70178985595703
campusoutdoors2_9,25,6,48,-23,2.882514476776123,25.88251495361328
campusoutdoors2_9,25,7,48,-23,11.621769905090332,34.621768951416016
fakeplants_0,24,1,44,-20,5.773714542388916,25.773714065551758
fakeplants_0,24,2,48,-24,-0.8862814903259277,23.113718032836914
fakeplants_0,24,3,47,-23,-2.327744960784912,20.67225456237793
fakeplants_0,24,4,45,-21,-1.7692397832870483,19.23076057434082
fakeplants_0,24,5,43,-19,-2.0573346614837646,16.942665100097656
fakeplants_0,24,6,41,-17,4.38112211227417,21.381122589111328
fakeplants_0,24,7,45,-21,4.282626152038574,25.28262710571289
fakeplants_1,21,1,41,-20,-8.967935562133789,11.032064437866211
fakeplants_1,21,2,32,-11,-15.239564895629883,4.239564895629883
fakeplants_2,21,1,41,-20,-5.398473262786865,14.601526260375977
fakeplants_2,21,2,36,-15,-5.242647647857666,9.757352828979492
fakeplants_2,21,3,31,-10,2.150400400161743,12.150400161743164
fakeplants_2,21,4,33,-12,-4.070930480957031,7.929069519042969
fakeplants_2,21,5,29,-8,-2.965965509414673,5.034034729003906
fakeplants_2,21,6,26,-5,2.0170958042144775,7.017095565795898
fakeplants_2,21,7,28,-7,0.5157228708267212,7.515722751617432
fakeplants_3,22,1,42,-20,3.2180850505828857,23.21808433532715
fakeplants_3,22,2,45,-23,3.23207688331604,26.23207664489746
fakeplants_3,22,3,48,-26,-0.4982983469963074,25.50170135498047
fakeplants_3,22,4,48,-26,1.6400820016860962,27.64008140563965
fakeplants_3,22,5,48,-26,-4.441042423248291,21.558958053588867
fakeplants_3,22,6,44,-22,2.1088476181030273,24.108848571777344
fakeplants_3,22,7,46,-24,5.905304908752441,29.905303955078125
fakeplants_4,24,1,44,-20,-9.731517791748047,10.268482208251953
fakeplants_4,24,2,34,-10,-9.50287914276123,0.49712085723876953
fakeplants_5,21,1,41,-20,3.8770322799682617,23.877033233642578
fakeplants_5,21,2,45,-24,4.053913593292236,28.053913116455078
fakeplants_5,21,3,48,-27,-4.523706436157227,22.476293563842773
fakeplants_5,21,4,43,-22,-0.9417781233787537,21.0582218170166
fakeplants_5,21,5,42,-21,-1.7764086723327637,19.223590850830078
fakeplants_5,21,6,40,-19,1.5063546895980835,20.50635528564453
fakeplants_5,21,7,42,-21,3.2207860946655273,24.220787048339844
fakeplants_6,21,1,41,-20,-15.379817008972168,4.620182991027832
fakeplants_7,23,1,43,-20,-11.010698318481445,8.989301681518555
fakeplants_7,23,2,32,-9,-4.0642523765563965,4.9357476234436035
fakeplants_8,21,1,41,-20,-10.137145042419434,9.862854957580566
fakeplants_8,21,2,31,-10,-10.867599487304688,0.8675994873046875
fakeplants_9,21,1,41,-20,2.853466033935547,22.853466033935547
fakeplants_9,21,2,44,-23,-7.27267599105835,15.727323532104492
fakeplants_9,21,3,37,-16,-6.024860382080078,9.975139617919922
fakeplants_9,21,4,31,-10,-2.8534176349639893,7.14658260345459
fakeplants_9,21,5,28,-7,0.3437705636024475,7.343770503997803
fakeplants_9,21,6,28,-7,-7.221940517425537,0.2219405174255371
garage2_0,22,1,42,-20,-13.086917877197266,6.913082122802734
garage2_0,22,2,29,-7,-11.351484298706055,4.351484298706055
garage2_1,24,1,44,-20,-12.081462860107422,7.918537139892578
garage2_1,24,2,32,-8,-6.264726638793945,1.7352733612060547
garage2_2,31,1,48,-17,-2.7818455696105957,14.218154907226562
garage2_2,31,2,45,-14,-5.556543350219727,8.443456649780273
garage2_2,31,3,39,-8,5.143211841583252,13.143211364746094
garage2_2,31,4,44,-13,4.511350631713867,17.511350631713867
garage2_2,31,5,48,-17,-7.259885311126709,9.740114212036133
garage2_2,31,6,41,-10,6.399020195007324,16.39902114868164
garage2_2,31,7,47,-16,-5.901530742645264,10.098468780517578
garage2_4,24,1,44,-20,-11.024824142456055,8.975175857543945
garage2_4,24,2,33,-9,-1.3066847324371338,7.693315505981445
garage2_4,24,3,32,-8,-8.087331771850586,0.08733177185058594
garage2_6,26,1,46,-20,5.517238140106201,25.51723861694336
garage2_6,26,2,48,-22,17.855873107910156,39.855873107910156
garage2_6,26,3,48,-22,0.2761978507041931,22.27619743347168
garage2_6,26,4,48,-22,2.7833268642425537,24.783327102661133
garage2_6,26,5,48,-22,-12.771136283874512,9.228863716125488
garage2_6,26,6,35,-9,6.377016067504883,15.377016067504883
garage2_6,26,7,41,-15,-3.624032974243164,11.375967025756836
garage2_7,24,1,44,-20,-6.65128231048584,13.34871768951416
garage2_7,24,2,37,-13,-3.579338312149048,9.420661926269531
garage2_7,24,3,33,-9,-5.963364601135254,3.036635398864746
garage2_8,21,1,41,-20,-14.683826446533203,5.316173553466797
garage2_8,21,2,26,-5,-7.63047981262207,2.6304798126220703
garage2_9,23,1,43,-20,-10.876372337341309,9.123627662658691
garage2_9,23,2,32,-9,-4.8851318359375,4.1148681640625
garage_0,25,1,45,-20,5.126136779785156,25.126136779785156
garage_0,25,2,48,-23,-0.9687997698783875,22.031200408935547
garage_0,25,3,47,-22,0.23828256130218506,22.238283157348633
garage_0,25,4,47,-22,-1.7630228996276855,20.236976623535156
garage_0,25,5,45,-20,-1.0815294981002808,18.91847038269043
garage_0,25,6,44,-19,-2.514993190765381,16.48500633239746
garage_0,25,7,41,-16,-0.04653047025203705,15.953469276428223
garage_1,27,1,47,-20,2.639523983001709,22.639524459838867
garage_1,27,2,48,-21,-0.527113676071167,20.47288703918457
garage_1,27,3,47,-20,1.9565927982330322,21.956592559814453
garage_1,27,4,48,-21,1.7082949876785278,22.708295822143555
garage_1,27,5,48,-21,1.9808951616287231,22.98089599609375
garage_1,27,6,48,-21,9.196161270141602,30.1961612701416
garage_1,27,7,48,-21,4.88029146194458,25.880290985107422
garage_3,22,1,42,-20,-8.049022674560547,11.950977325439453
garage_3,22,2,34,-12,-6.633655071258545,5.366344928741455
garage_3,22,3,27,-5,-4.002804756164551,0.9971952438354492
garage_4,44,1,48,-4,-2.4768621921539307,1.5231378078460693
garage_6,27,1,47,-20,-7.2943243980407715,12.70567512512207
garage_6,27,2,40,-13,-5.961013317108154,7.038986682891846
garage_6,27,3,34,-7,-4.347469806671143,2.6525301933288574
garage_7,22,1,42,-20,-7.90086030960083,12.099140167236328
garage_7,22,2,34,-12,-7.868608474731445,4.131391525268555
garage_8,44,1,48,-4,-10.178691864013672,6.178691864013672
garage_8,44,2,38,6,6.0956268310546875,0.0956268310546875
garage_9,20,1,40,-20,-20.377717971801758,0.3777179718017578
hallway1_0,32,1,48,-16,-4.480647087097168,11.519352912902832
hallway1_0,32,2,44,-12,-4.816483974456787,7.183516025543213
hallway1_0,32,3,39,-7,0.6179449558258057,7.617944717407227
hallway1_0,32,4,40,-8,-2.9730262756347656,5.026973724365234
hallway1_0,32,5,37,-5,-8.667505264282227,3.6675052642822266
hallway1_2,33,1,48,-15,-9.04038143157959,5.95961856842041
hallway1_2,33,2,39,-6,0.6805554628372192,6.68055534362793
hallway1_2,33,3,40,-7,5.259821891784668,12.259821891784668
hallway1_2,33,4,45,-12,-5.977076530456543,6.022923469543457
hallway1_2,33,5,39,-6,-6.142102241516113,0.14210224151611328
hallway1_3,26,1,46,-20,-6.313785552978516,13.686214447021484
hallway1_3,26,2,40,-14,-6.094675064086914,7.905324935913086
hallway1_3,26,3,34,-8,-4.917980194091797,3.082019805908203
hallway1_4,23,1,43,-20,-10.124809265136719,9.875190734863281
hallway1_4,23,2,33,-10,-5.636797904968262,4.363202095031738
hallway1_5,22,1,42,-20,-13.904454231262207,6.095545768737793
hallway1_5,22,2,28,-6,-10.796294212341309,4.796294212341309
hallway1_6,22,1,42,-20,-8.151684761047363,11.848315238952637
hallway1_6,22,2,34,-12,4.497633934020996,16.497634887695312
hallway1_6,22,3,38,-16,-12.218145370483398,3.7818546295166016
hallway1_7,37,1,48,-11,-5.969147205352783,5.030852794647217
hallway1_7,37,2,42,-5,-6.629340171813965,1.6293401718139648
hallway2_0,29,1,48,-19,1.3764981031417847,20.376497268676758
hallway2_0,29,2,48,-19,3.863731622695923,22.863731384277344
hallway2_0,29,3,48,-19,-8.758156776428223,10.241843223571777
hallway2_0,29,4,39,-10,2.12373948097229,12.123739242553711
hallway2_0,29,5,41,-12,3.089141607284546,15.089141845703125
hallway2_0,29,6,44,-15,-8.288043022155762,6.711956977844238
hallway2_0,29,7,36,-7,5.685301780700684,12.685301780700684
hallway2_1,34,1,48,-14,3.566953420639038,17.566953659057617
hallway2_1,34,2,48,-14,3.4212372303009033,17.42123794555664
hallway2_1,34,3,48,-14,6.485250473022461,20.48525047302246
hallway2_1,34,4,48,-14,7.14630126953125,21.14630126953125
hallway2_1,34,5,48,-14,4.294987678527832,18.294986724853516
hallway2_1,34,6,48,-14,4.076559543609619,18.07655906677246
hallway2_1,34,7,48,-14,6.164836406707764,20.164836883544922
hallway2_2,25,1,45,-20,-8.448346138000488,11.551653861999512
hallway2_2,25,2,37,-12,-9.347365379333496,2.652634620666504
meetingroom1_7,19,1,39,-20,15.218721389770508,35.218719482421875
meetingroom1_7,19,2,48,-29,20.1239013671875,49.1239013671875
meetingroom1_7,19,3,48,-29,20.696624755859375,49.696624755859375
meetingroom1_7,19,4,48,-29,19.084976196289062,48.08497619628906
meetingroom1_7,19,5,48,-29,19.454105377197266,48.454105377197266
meetingroom1_7,19,6,48,-29,12.860834121704102,41.86083221435547
meetingroom1_7,19,7,48,-29,21.601858139038086,50.60186004638672
meetingroom1_8,21,1,41,-20,-8.658923149108887,11.341076850891113
meetingroom1_8,21,2,32,-11,-2.2298269271850586,8.770173072814941
meetingroom1_8,21,3,30,-9,-8.09357738494873,0.9064226150512695
meetingroom1_9,23,1,43,-20,-18.0853214263916,1.9146785736083984
meetingroom2_0,27,1,47,-20,-6.059950351715088,13.94005012512207
meetingroom2_0,27,2,41,-14,-1.207419753074646,12.792580604553223
meetingroom2_0,27,3,40,-13,-5.026134014129639,7.973865985870361
meetingroom2_0,27,4,35,-8,-2.1521098613739014,5.8478899002075195
meetingroom2_0,27,5,33,-6,-0.5826336145401001,5.4173665046691895
meetingroom2_0,27,6,32,-5,1.972927212715149,6.972927093505859
meetingroom2_0,27,7,34,-7,3.544589042663574,10.544589042663574
meetingroom2_1,23,1,43,-20,-14.524928092956543,5.475071907043457
meetingroom2_1,23,2,28,-5,-6.512088775634766,1.5120887756347656
meetingroom2_2,24,1,44,-20,-0.4816644489765167,19.518335342407227
meetingroom2_2,24,2,44,-20,-0.8993291854858398,19.100669860839844
meetingroom2_2,24,3,43,-19,-1.1262767314910889,17.87372398376465
meetingroom2_2,24,4,42,-18,-5.85414457321167,12.145854949951172
meetingroom2_2,24,5,36,-12,2.848179578781128,14.848179817199707
meetingroom2_2,24,6,39,-15,-3.0883848667144775,11.911615371704102
meetingroom2_2,24,7,36,-12,-10.718310356140137,1.2816896438598633
meetingroom2_3,29,1,48,-19,-1.7621773481369019,17.237823486328125
meetingroom2_3,29,2,46,-17,-4.739184379577637,12.260815620422363
meetingroom2_3,29,3,41,-12,-6.966237545013428,5.033762454986572
meetingroom2_3,29,4,34,-5,-3.321237802505493,1.6787621974945068
meetingroom2_4,22,1,42,-20,5.808785438537598,25.80878448486328
meetingroom2_4,22,2,48,-26,-1.4283252954483032,24.571674346923828
meetingroom2_4,22,3,47,-25,7.071241855621338,32.07124328613281
meetingroom2_4,22,4,48,-26,-0.18252655863761902,25.817474365234375
meetingroom2_4,22,5,48,-26,-0.15634244680404663,25.843658447265625
meetingroom2_4,22,6,48,-26,-0.2991293966770172,25.700870513916016
meetingroom2_4,22,7,48,-26,6.391331195831299,32.39133071899414
meetingroom2_5,24,1,44,-20,5.957038402557373,25.95703887939453
meetingroom2_5,24,2,48,-24,5.776910781860352,29.77691078186035
meetingroom2_5,24,3,48,-24,0.8801167011260986,24.880117416381836
meetingroom2_5,24,4,48,-24,2.7988007068634033,26.79880142211914
meetingroom2_5,24,5,48,-24,5.829109191894531,29.82910919189453
meetingroom2_5,24,6,48,-24,5.199556827545166,29.199556350708008
meetingroom2_5,24,7,48,-24,3.768422842025757,27.768423080444336
meetingroom2_6,26,1,46,-20,-14.153361320495605,5.8466386795043945
meetingroom2_6,26,2,32,-6,-5.155428886413574,0.8445711135864258
meetingroom2_7,28,1,48,-20,-13.668522834777832,6.331477165222168
meetingroom2_7,28,2,34,-6,-4.998319625854492,1.0016803741455078
meetingroom2_8,28,1,48,-20,-6.592253684997559,13.407746315002441
meetingroom2_8,28,2,41,-13,-13.303437232971191,0.3034372329711914
meetingroom2_9,31,1,48,-17,-3.036592721939087,13.963407516479492
meetingroom2_9,31,2,45,-14,-1.6194396018981934,12.380559921264648
meetingroom2_9,31,3,43,-12,-5.7285261154174805,6.2714738845825195
meetingroom2_9,31,4,37,-6,-2.1926114559173584,3.8073885440826416
officecrawl1_0,26,1,46,-20,-1.241576075553894,18.758424758911133
officecrawl1_0,26,2,45,-19,-3.538065195083618,15.461935043334961
officecrawl1_0,26,3,41,-15,-10.988712310791016,4.011287689208984
officecrawl1_1,36,1,48,-12,-3.7296926975250244,8.270307540893555
officecrawl1_1,36,2,44,-8,-4.709046840667725,3.2909531593322754
officecrawl1_2,26,1,46,-20,-9.391799926757812,10.608200073242188
officecrawl1_2,26,2,37,-11,-11.5531644821167,0.5531644821166992
officecrawl1_3,21,1,41,-20,-6.0231781005859375,13.976821899414062
officecrawl1_3,21,2,35,-14,-6.889532566070557,7.110467433929443
officecrawl1_3,21,3,28,-7,8.932843208312988,15.932843208312988
officecrawl1_3,21,4,37,-16,14.65686321258545,30.656864166259766
officecrawl1_3,21,5,48,-27,6.163878440856934,33.16387939453125
officecrawl1_3,21,6,48,-27,3.7887461185455322,30.788745880126953
officecrawl1_3,21,7,48,-27,-5.574878215789795,21.425121307373047
officecrawl1_4,31,1,48,-17,4.150515079498291,21.150514602661133
officecrawl1_4,31,2,48,-17,-10.666977882385254,6.333022117614746
officecrawl1_4,31,3,37,-6,-7.222444534301758,1.2224445343017578
officecrawl1_5,23,1,43,-20,-2.7403512001037598,17.2596492767334
officecrawl1_5,23,2,40,-17,-3.2472989559173584,13.752700805664062
officecrawl1_5,23,3,37,-14,-1.829991340637207,12.170008659362793
officecrawl1_5,23,4,35,-12,-4.2752156257629395,7.7247843742370605
officecrawl1_5,23,5,31,-8,-1.3432209491729736,6.6567792892456055
officecrawl1_5,23,6,30,-7,-5.0984649658203125,1.9015350341796875
officecrawl1_6,27,1,47,-20,26.853256225585938,46.85325622558594
officecrawl1_6,27,2,48,-21,13.15954875946045,34.159549713134766
officecrawl1_6,27,3,48,-21,18.947927474975586,39.94792938232422
officecrawl1_6,27,4,48,-21,22.858339309692383,43.85833740234375
officecrawl1_6,27,5,48,-21,47.04936218261719,68.04936218261719
officecrawl1_6,27,6,48,-21,10.810296058654785,31.81029510498047
officecrawl1_6,27,7,48,-21,11.905457496643066,32.90545654296875
officecrawl1_7,20,1,40,-20,-4.792573928833008,15.207426071166992
officecrawl1_7,20,2,35,-15,-5.040431976318359,9.95956802368164
officecrawl1_7,20,3,30,-10,-0.10412818938493729,9.895872116088867
officecrawl1_7,20,4,30,-10,4.7379889488220215,14.73798942565918
officecrawl1_7,20,5,35,-15,-3.53165602684021,11.468343734741211
officecrawl1_7,20,6,31,-11,1.129037857055664,12.129037857055664
officecrawl1_7,20,7,32,-12,5.235949516296387,17.235950469970703
officecrawl1_8,32,1,48,-16,-10.403287887573242,5.596712112426758
officecrawl1_8,32,2,38,-6,-3.2676360607147217,2.7323639392852783
officecrawl1_9,33,1,48,-15,-3.514599084854126,11.485401153564453
officecrawl1_9,33,2,44,-11,-2.0352935791015625,8.964706420898438
officecrawl1_9,33,3,42,-9,0.1907155066728592,9.190715789794922
officecrawl1_9,33,4,42,-9,-4.255393981933594,4.744606018066406
officecrawl2_0,31,1,48,-17,4.953667163848877,21.95366668701172
officecrawl2_0,31,2,48,-17,0.5700647830963135,17.570064544677734
officecrawl2_0,31,3,48,-17,3.087968349456787,20.087968826293945
officecrawl2_0,31,4,48,-17,-1.6607061624526978,15.339293479919434
officecrawl2_0,31,5,46,-15,-1.615472674369812,13.384527206420898
officecrawl2_0,31,6,44,-13,0.7426689267158508,13.742669105529785
officecrawl2_0,31,7,45,-14,1.3489463329315186,15.348946571350098
officecrawl2_1,24,1,44,-20,-10.222563743591309,9.777436256408691
officecrawl2_1,24,2,34,-10,-5.718555450439453,4.281444549560547
officecrawl2_2,48,1,48,0,-0.6867683529853821,0.6867683529853821
officecrawl2_3,42,1,48,-6,-3.121107816696167,2.878892183303833
officecrawl2_4,24,1,44,-20,-0.5736373662948608,19.426362991333008
officecrawl2_4,24,2,43,-19,-8.736774444580078,10.263225555419922
officecrawl2_4,24,3,34,-10,-4.669643878936768,5.330356121063232
officecrawl2_4,24,4,29,-5,-0.8204231262207031,4.179576873779297
officecrawl2_6,28,1,48,-20,-3.1990997791290283,16.800899505615234
officecrawl2_6,28,2,45,-17,-8.270370483398438,8.729629516601562
officecrawl2_6,28,3,37,-9,0.027089914306998253,9.027090072631836
officecrawl2_6,28,4,37,-9,-2.6406633853912354,6.359336853027344
officecrawl2_6,28,5,34,-6,-1.3254307508468628,4.674569129943848
officecrawl2_7,33,1,48,-15,-7.366197109222412,7.633802890777588
officecrawl2_7,33,2,41,-8,-5.669969081878662,2.330030918121338
officecrawl2_8,22,1,42,-20,-12.48782730102539,7.512172698974609
officecrawl2_8,22,2,30,-8,-9.76909351348877,1.7690935134887695
officecrawl2_9,27,1,47,-20,8.254669189453125,28.254669189453125
officecrawl2_9,27,2,48,-21,6.581783294677734,27.581783294677734
officecrawl2_9,27,3,48,-21,6.207927227020264,27.207927703857422
officecrawl2_9,27,4,48,-21,4.584897041320801,25.584896087646484
officecrawl2_9,27,5,48,-21,6.841220378875732,27.84122085571289
officecrawl2_9,27,6,48,-21,5.0393385887146,26.039339065551758
officecrawl2_9,27,7,48,-21,6.974964141845703,27.974964141845703
officecrawl3_1,26,1,46,-20,-14.467885971069336,5.532114028930664
officecrawl3_1,26,2,32,-6,-7.141963958740234,1.1419639587402344
officecrawl3_2,24,1,44,-20,-1.0740901231765747,18.9259090423584
officecrawl3_2,24,2,43,-19,-22.586631774902344,3.5866317749023438
officecrawl3_3,32,1,48,-16,2.392547845840454,18.392547607421875
officecrawl3_3,32,2,48,-16,-3.4325296878814697,12.56747055053711
officecrawl3_3,32,3,45,-13,1.9900453090667725,14.990045547485352
officecrawl3_3,32,4,47,-15,-6.911662578582764,8.088336944580078
officecrawl3_3,32,5,40,-8,-2.980067729949951,5.019932270050049
officecrawl3_3,32,6,37,-5,-1.2755498886108398,3.72445011138916
officecrawl3_4,20,1,40,-20,-7.517482280731201,12.48251724243164
officecrawl3_4,20,2,32,-12,-12.040495872497559,0.040495872497558594
officecrawl3_5,27,1,47,-20,2.369274139404297,22.369274139404297
officecrawl3_5,27,2,48,-21,-6.442323684692383,14.557676315307617
officecrawl3_5,27,3,42,-15,-2.837651252746582,12.162348747253418
officecrawl3_5,27,4,39,-12,-11.361580848693848,0.6384191513061523
officecrawl3_6,26,1,46,-20,-9.657025337219238,10.342974662780762
officecrawl3_6,26,2,36,-10,-4.637515544891357,5.362484455108643
officecrawl3_6,26,3,31,-5,1.4756633043289185,6.475663185119629
officecrawl3_6,26,4,32,-6,-11.084758758544922,5.084758758544922
officecrawl3_6,26,5,21,5,7.530473709106445,2.5304737091064453
officecrawl3_7,28,1,48,-20,-3.0543501377105713,16.945650100708008
officecrawl3_7,28,2,45,-17,-5.054527759552002,11.945472717285156
officecrawl3_7,28,3,40,-12,-4.774698257446289,7.225301742553711
officecrawl3_7,28,4,35,-7,0.9504932165145874,7.950493335723877
officecrawl3_7,28,5,36,-8,-0.6385524868965149,7.361447334289551
officecrawl3_7,28,6,35,-7,-3.804589033126831,3.195410966873169
officecrawl3_8,19,1,39,-20,-13.306652069091797,6.693347930908203
officecrawl3_8,19,2,26,-7,-8.856430053710938,1.8564300537109375
officecrawl3_9,25,1,45,-20,15.99642276763916,35.996421813964844
officecrawl3_9,25,2,48,-23,-0.7338771820068359,22.266122817993164
officecrawl3_9,25,3,47,-22,10.657814025878906,32.657814025878906
officecrawl3_9,25,4,48,-23,12.822778701782227,35.822776794433594
officecrawl3_9,25,5,48,-23,11.46794319152832,34.46794128417969
officecrawl3_9,25,6,48,-23,11.308828353881836,34.30883026123047
officecrawl3_9,25,7,48,-23,-7.084010601043701,15.91598892211914
officeroom1_0,27,1,47,-20,6.544694900512695,26.544694900512695
officeroom1_0,27,2,48,-21,0.10673096776008606,21.106731414794922
officeroom1_0,27,3,48,-21,1.6777251958847046,22.677724838256836
officeroom1_0,27,4,48,-21,3.819121837615967,24.819122314453125
officeroom1_0,27,5,48,-21,9.619736671447754,30.619735717773438
officeroom1_0,27,6,48,-21,32.64545440673828,53.64545440673828
officeroom1_0,27,7,48,-21,14.647968292236328,35.64796829223633
officeroom1_1,28,1,48,-20,-9.903632164001465,10.096367835998535
officeroom1_1,28,2,38,-10,-0.720227837562561,9.27977180480957
officeroom1_1,28,3,37,-9,-12.556747436523438,3.5567474365234375
officeroom1_2,29,1,48,-19,-4.586704730987549,14.41329574584961
officeroom1_2,29,2,43,-14,-6.7410807609558105,7.2589192390441895
officeroom1_2,29,3,36,-7,-4.8104472160339355,2.1895527839660645
officeroom1_3,29,1,48,-19,-21.303159713745117,2.303159713745117
officeroom1_4,21,1,41,-20,-8.37876033782959,11.62123966217041
officeroom1_4,21,2,33,-12,-2.624260663986206,9.375739097595215
officeroom1_4,21,3,30,-9,-6.612247467041016,2.3877525329589844
officeroom1_5,22,1,42,-20,-3.837106943130493,16.162893295288086
officeroom1_5,22,2,38,-16,-4.327131271362305,11.672868728637695
officeroom1_5,22,3,34,-12,-5.7386908531188965,6.2613091468811035
officeroom1_5,22,4,28,-6,-1.2421002388000488,4.757899761199951
officeroom1_6,22,1,42,-20,-8.026124954223633,11.973875045776367
officeroom1_6,22,2,34,-12,-4.181034564971924,7.818965435028076
officeroom1_6,22,3,30,-8,-10.599597930908203,2.599597930908203
officeroom1_7,22,1,42,-20,0.3999539315700531,20.399953842163086
officeroom1_7,22,2,42,-20,-0.16915740072727203,19.830842971801758
officeroom1_7,22,3,42,-20,16.210180282592773,36.210182189941406
officeroom1_7,22,4,48,-26,15.630989074707031,41.63098907470703
officeroom1_7,22,5,48,-26,5.793808460235596,31.793807983398438
officeroom1_7,22,6,48,-26,-0.13741876184940338,25.862581253051758
officeroom1_7,22,7,48,-26,1.7128976583480835,27.71289825439453
officeroom1_8,22,1,42,-20,-16.69491195678711,3.3050880432128906
officeroom1_9,27,1,47,-20,-8.071430206298828,11.928569793701172
officeroom1_9,27,2,39,-12,-10.396483421325684,1.6035165786743164
officetrashshadows_1,34,1,48,-14,2.572122812271118,16.57212257385254
officetrashshadows_1,34,2,48,-14,-3.9136364459991455,10.086363792419434
officetrashshadows_1,34,3,44,-10,6.801845073699951,16.80184555053711
officetrashshadows_1,34,4,48,-14,-0.8550183773040771,13.144981384277344
officetrashshadows_1,34,5,47,-13,1.5280117988586426,14.528011322021484
officetrashshadows_1,34,6,48,-14,1.6484519243240356,15.648451805114746
officetrashshadows_1,34,7,48,-14,2.345421075820923,16.345420837402344
officetrashshadows_2,23,1,43,-20,4.434105396270752,24.434104919433594
officetrashshadows_2,23,2,47,-24,2.8006205558776855,26.800621032714844
officetrashshadows_2,23,3,48,-25,1.3172000646591187,26.31719970703125
officetrashshadows_2,23,4,48,-25,2.8964295387268066,27.89642906188965
officetrashshadows_2,23,5,48,-25,1.5007455348968506,26.50074577331543
officetrashshadows_2,23,6,48,-25,3.8662140369415283,28.866214752197266
officetrashshadows_2,23,7,48,-25,4.310585975646973,29.310585021972656
officetrashshadows_3,27,1,47,-20,-7.915344715118408,12.08465576171875
officetrashshadows_3,27,2,39,-12,-2.785165548324585,9.214834213256836
officetrashshadows_3,27,3,36,-9,-9.800946235656738,0.8009462356567383
officetrashshadows_4,36,1,48,-12,-4.532279014587402,7.467720985412598
officetrashshadows_4,36,2,43,-7,8.081478118896484,15.081478118896484
officetrashshadows_4,36,3,48,-12,-6.709493637084961,5.290506362915039
officetrashshadows_4,36,4,41,-5,-1.3764843940734863,3.6235156059265137
officetrashshadows_5,39,1,48,-9,-4.142398834228516,4.857601165771484
officetrashshadows_6,37,1,48,-11,-6.214868545532227,4.785131454467773
officetrashshadows_8,25,1,45,-20,-7.360379695892334,12.639619827270508
officetrashshadows_8,25,2,38,-13,-8.00953197479248,4.9904680252075195
officetrashshadows_9,27,1,47,-20,-12.047801971435547,7.952198028564453
officetrashshadows_9,27,2,35,-8,-5.571558475494385,2.4284415245056152
officetrash_0,26,1,46,-20,-17.61899185180664,2.3810081481933594
officetrash_1,23,1,43,-20,-7.333740234375,12.666259765625
officetrash_1,23,2,36,-13,1.036534309387207,14.036534309387207
officetrash_1,23,3,37,-14,-9.32927131652832,4.67072868347168
officetrash_2,25,1,45,-20,-4.146689414978027,15.853310585021973
officetrash_2,25,2,41,-16,-8.607549667358398,7.392450332641602
officetrash_2,25,3,32,-7,-0.17300012707710266,6.826999664306641
officetrash_2,25,4,32,-7,-0.2750912010669708,6.724908828735352
officetrash_2,25,5,32,-7,-7.194287300109863,0.19428730010986328
officetrash_4,33,1,48,-15,-13.69715404510498,1.3028459548950195
officetrash_5,32,1,48,-16,-4.95535135269165,11.044649124145508
officetrash_5,32,2,43,-11,1.8955262899398804,12.895525932312012
officetrash_5,32,3,45,-13,-7.224730968475342,5.775269031524658
officetrash_5,32,4,38,-6,-1.8625245094299316,4.137475490570068
officetrash_6,24,1,44,-20,-0.07576624304056168,19.92423439025879
officetrash_6,24,2,44,-20,-5.21933126449585,14.780668258666992
officetrash_6,24,3,39,-15,-7.343348026275635,7.656651973724365
officetrash_6,24,4,32,-8,0.8129869699478149,8.812987327575684
officetrash_6,24,5,33,-9,-8.556062698364258,0.4439373016357422
officetrash_7,31,1,48,-17,-10.150762557983398,6.849237442016602
officetrash_7,31,2,38,-7,-2.2951765060424805,4.7048234939575195
officetrash_8,25,1,45,-20,-2.9511401653289795,17.048860549926758
officetrash_8,25,2,42,-17,-4.584431171417236,12.415569305419922
officetrash_8,25,3,37,-12,3.447636604309082,15.447636604309082
officetrash_8,25,4,40,-15,-5.8953351974487305,9.10466480255127
officetrash_8,25,5,34,-9,-7.590301513671875,1.409698486328125
outdoorsbalcony1_0,24,1,44,-20,-21.225879669189453,1.2258796691894531
outdoorsbalcony1_1,23,1,43,-20,-20.283533096313477,0.28353309631347656
outdoorsbalcony1_2,33,1,48,-15,-7.503992557525635,7.496007442474365
outdoorsbalcony1_2,33,2,40,-7,11.548372268676758,18.548372268676758
outdoorsbalcony1_2,33,3,48,-15,7.856249809265137,22.856250762939453
outdoorsbalcony1_2,33,4,48,-15,-7.529377460479736,7.470622539520264
outdoorsbalcony1_2,33,5,40,-7,7.401764392852783,14.401763916015625
outdoorsbalcony1_2,33,6,47,-14,13.236556053161621,27.236557006835938
outdoorsbalcony1_2,33,7,48,-15,-2.4222724437713623,12.577727317810059
outdoorsbalcony1_3,44,1,48,-4,-3.4910244941711426,0.5089755058288574
outdoorsbalcony1_4,29,1,48,-19,-5.892735004425049,13.10726547241211
outdoorsbalcony1_4,29,2,42,-13,-6.039861679077148,6.960138320922852
outdoorsbalcony1_4,29,3,36,-7,1.4587703943252563,8.458770751953125
outdoorsbalcony1_4,29,4,37,-8,-3.7543792724609375,4.2456207275390625
outdoorsbalcony1_6,29,1,48,-19,-8.256113052368164,10.743886947631836
outdoorsbalcony1_6,29,2,40,-11,-10.14696216583252,0.8530378341674805
outdoorsbalcony1_9,38,1,48,-10,-4.699646949768066,5.300353050231934
outdoorsbalcony1_9,38,2,43,-5,-2.7310783863067627,2.2689216136932373
outdoorsbalcony2_0,23,1,43,-20,-7.710882663726807,12.289117813110352
outdoorsbalcony2_0,23,2,35,-12,-7.0728678703308105,4.9271321296691895
outdoorsbalcony2_1,27,1,47,-20,-13.885575294494629,6.114424705505371
outdoorsbalcony2_1,27,2,33,-6,-4.834471225738525,1.1655287742614746
outdoorsbalcony2_2,34,1,48,-14,-12.100457191467285,1.8995428085327148
outdoorsbalcony2_4,21,1,41,-20,-8.50731372833252,11.49268627166748
outdoorsbalcony2_4,21,2,32,-11,-5.1834397315979,5.8165602684021
outdoorsbalcony2_4,21,3,27,-6,-7.070105075836182,1.0701050758361816
outdoorsbalcony2_5,23,1,43,-20,-11.212059020996094,8.787940979003906
outdoorsbalcony2_5,23,2,32,-9,-5.204084873199463,3.795915126800537
outdoorsbalcony2_6,26,1,46,-20,-17.478792190551758,2.521207809448242
outdoorsbalcony2_7,27,1,47,-20,-7.235550880432129,12.764449119567871
outdoorsbalcony2_7,27,2,40,-13,-6.088099956512451,6.911900043487549
outdoorsbalcony2_7,27,3,34,-7,-2.428990364074707,4.571009635925293
outdoorsbalcony2_8,24,1,44,-20,-22.667238235473633,2.667238235473633
outdoorsbalcony2_9,21,1,41,-20,-10.407859802246094,9.592140197753906
outdoorsbalcony2_9,21,2,31,-10,-10.266606330871582,0.26660633087158203
outdoorsfossils_3,24,1,44,-20,-12.027101516723633,7.972898483276367
outdoorsfossils_3,24,2,32,-8,-7.337652206420898,0.6623477935791016
outdoorsfossils_5,25,1,45,-20,-10.984551429748535,9.015448570251465
outdoorsfossils_5,25,2,34,-9,-9.42427921295166,0.42427921295166016
outdoorsfossils_6,24,1,44,-20,-2.136528968811035,17.86347198486328
outdoorsfossils_6,24,2,42,-18,14.229327201843262,32.22932815551758
outdoorsfossils_6,24,3,48,-24,10.187093734741211,34.187095642089844
outdoorsfossils_6,24,4,48,-24,11.505176544189453,35.50517654418945
outdoorsfossils_6,24,5,48,-24,-7.574016094207764,16.425983428955078
outdoorsfossils_6,24,6,40,-16,-2.680446147918701,13.31955337524414
outdoorsfossils_6,24,7,37,-13,3.815953254699707,16.81595230102539
outdoorsfossils_7,23,1,43,-20,-11.857159614562988,8.142840385437012
outdoorsfossils_7,23,2,31,-8,-6.803799152374268,1.1962008476257324
outdoorsfossils_8,24,1,44,-20,-2.402000665664673,17.597999572753906
outdoorsfossils_8,24,2,42,-18,-9.508269309997559,8.491730690002441
outdoorsfossils_8,24,3,32,-8,-2.5715749263763428,5.428424835205078
outdoorsfossils_8,24,4,29,-5,-0.9992554187774658,4.000744819641113
outdoorsfossils_9,25,1,45,-20,-13.079889297485352,6.920110702514648
outdoorsfossils_9,25,2,32,-7,-2.6530823707580566,4.346917629241943
outdoorsplants_0,37,1,48,-11,-5.391534805297852,5.608465194702148
outdoorsplants_0,37,2,43,-6,-12.400129318237305,6.400129318237305
outdoorsplants_0,37,3,31,6,0.31138578057289124,5.688614368438721
outdoorsplants_0,37,4,31,6,3.2475361824035645,2.7524638175964355
outdoorsplants_1,34,1,48,-14,16.336307525634766,30.336307525634766
outdoorsplants_1,34,2,48,-14,13.44193172454834,27.441932678222656
outdoorsplants_1,34,3,48,-14,18.611570358276367,32.611572265625
outdoorsplants_1,34,4,48,-14,16.14884376525879,30.14884376525879
outdoorsplants_1,34,5,48,-14,14.694842338562012,28.694843292236328
outdoorsplants_1,34,6,48,-14,11.06523323059082,25.06523323059082
outdoorsplants_1,34,7,48,-14,9.70080280303955,23.700801849365234
outdoorsplants_2,32,1,48,-16,19.250097274780273,35.250099182128906
outdoorsplants_2,32,2,48,-16,11.577332496643066,27.57733154296875
outdoorsplants_2,32,3,48,-16,20.349470138549805,36.34947204589844
outdoorsplants_2,32,4,48,-16,13.20326042175293,29.20326042175293
outdoorsplants_2,32,5,48,-16,11.493485450744629,27.493484497070312
outdoorsplants_2,32,6,48,-16,14.036699295043945,30.036699295043945
outdoorsplants_2,32,7,48,-16,17.040802001953125,33.040802001953125
outdoorsplants_3,23,1,43,-20,-19.552953720092773,0.44704627990722656
outdoorsplants_6,25,1,45,-20,0.43562543392181396,20.435625076293945
outdoorsplants_6,25,2,45,-20,-17.96668243408203,2.0333175659179688
outdoorsplants_7,19,1,39,-20,-16.966094970703125,3.033905029296875
outdoorsplants_8,20,1,40,-20,-18.941883087158203,1.0581169128417969
outdoorsplants_9,23,1,43,-20,-6.332706928253174,13.667293548583984
outdoorsplants_9,23,2,37,-14,5.579070091247559,19.579071044921875
outdoorsplants_9,23,3,43,-20,2.7289540767669678,22.728954315185547
outdoorsplants_9,23,4,46,-23,-1.0784317255020142,21.921567916870117
outdoorsplants_9,23,5,45,-22,3.1396524906158447,25.139652252197266
outdoorsplants_9,23,6,48,-25,4.5281219482421875,29.528121948242188
outdoorsplants_9,23,7,48,-25,-4.142146110534668,20.857852935791016
photobox1_0,22,1,42,-20,-3.7133688926696777,16.286630630493164
photobox1_0,22,2,38,-16,-9.636652946472168,6.363347053527832
photobox1_0,22,3,28,-6,-9.69714069366455,3.697140693664551
photobox1_1,22,1,42,-20,-11.53929615020752,8.46070384979248
photobox1_1,22,2,30,-8,-8.613804817199707,0.613804817199707
photobox1_2,22,1,42,-20,-10.882240295410156,9.117759704589844
photobox1_2,22,2,31,-9,-9.078080177307129,0.0780801773071289
photobox1_3,23,1,43,-20,-23.170976638793945,3.1709766387939453
photobox1_4,21,1,41,-20,-19.374841690063477,0.6251583099365234
photobox1_5,22,1,42,-20,-8.439899444580078,11.560100555419922
photobox1_5,22,2,34,-12,-5.3273186683654785,6.6726813316345215
photobox1_5,22,3,29,-7,-6.487232208251953,0.5127677917480469
photobox1_6,23,1,43,-20,1.7726000547409058,21.772600173950195
photobox1_6,23,2,45,-22,4.905545711517334,26.905546188354492
photobox1_6,23,3,48,-25,0.14817745983600616,25.148178100585938
photobox1_6,23,4,48,-25,6.434884071350098,31.43488311767578
photobox1_6,23,5,48,-25,8.682676315307617,33.68267822265625
photobox1_6,23,6,48,-25,6.931331634521484,31.931331634521484
photobox1_6,23,7,48,-25,11.644280433654785,36.64427947998047
photobox1_7,22,1,42,-20,-9.762449264526367,10.237550735473633
photobox1_7,22,2,32,-10,-5.244731426239014,4.755268573760986
photobox1_8,22,1,42,-20,-5.236932754516602,14.763067245483398
photobox1_8,22,2,37,-15,-6.563375473022461,8.436624526977539
photobox1_8,22,3,30,-8,-2.5868170261383057,5.413183212280273
photobox1_8,22,4,27,-5,0.43358251452445984,5.433582305908203
photobox1_8,22,5,27,-5,-1.6515252590179443,3.3484747409820557
photobox1_9,26,1,46,-20,-8.621370315551758,11.378629684448242
photobox1_9,26,2,37,-11,-6.0837860107421875,4.9162139892578125
photobox2_0,23,1,43,-20,6.146093368530273,26.146093368530273
photobox2_0,23,2,48,-25,-4.3009257316589355,20.699073791503906
photobox2_0,23,3,44,-21,-5.287590026855469,15.712409973144531
photobox2_0,23,4,39,-16,0.09599141776561737,16.095991134643555
photobox2_0,23,5,39,-16,-1.6621029376983643,14.337897300720215
photobox2_0,23,6,37,-14,-2.1407365798950195,11.85926342010498
photobox2_0,23,7,35,-12,9.718961715698242,21.718961715698242
photobox2_1,23,1,43,-20,-12.909784317016602,7.090215682983398
photobox2_1,23,2,30,-7,-14.21644115447998,7.2164411544799805
photobox2_1,23,3,16,7,4.392163276672363,2.6078367233276367
photobox2_2,23,1,43,-20,-16.509145736694336,3.490854263305664
photobox2_3,23,1,43,-20,12.075803756713867,32.0758056640625
photobox2_3,23,2,48,-25,-9.324606895446777,15.675393104553223
photobox2_3,23,3,39,-16,-4.383586883544922,11.616413116455078
photobox2_3,23,4,35,-12,-9.237874031066895,2.7621259689331055
photobox2_4,24,1,44,-20,-6.445393085479736,13.554607391357422
photobox2_4,24,2,38,-14,-9.55690860748291,4.44309139251709
photobox2_5,26,1,46,-20,-8.635499954223633,11.364500045776367
photobox2_5,26,2,37,-11,-5.417403697967529,5.582596302032471
photobox2_5,26,3,32,-6,-4.981488227844238,1.0185117721557617
photobox2_6,22,1,42,-20,-5.9578142166137695,14.04218578338623
photobox2_6,22,2,36,-14,-9.98667049407959,4.01332950592041
photobox2_7,22,1,42,-20,-13.620366096496582,6.379633903503418
photobox2_7,22,2,28,-6,-11.670886039733887,5.670886039733887
photobox2_7,22,3,16,6,5.279552936553955,0.7204470634460449
photobox2_8,29,1,48,-19,-13.191125869750977,5.808874130249023
photobox2_8,29,2,35,-6,5.711973190307617,11.711973190307617
photobox2_8,29,3,41,-12,-5.501309871673584,6.498690128326416
photobox2_8,29,4,35,-6,-0.7008431553840637,5.299156665802002
photobox2_8,29,5,34,-5,3.5889923572540283,8.58899211883545
photobox2_8,29,6,38,-9,1.0475530624389648,10.047553062438965
photobox2_8,29,7,39,-10,-6.432338237762451,3.567661762237549
photobox2_9,23,1,43,-20,-19.672060012817383,0.3279399871826172
randomsurplus_0,19,1,39,-20,22.8377628326416,42.83776092529297
randomsurplus_0,19,2,48,-29,33.78390121459961,62.78390121459961
randomsurplus_0,19,3,48,-29,-0.4101220965385437,28.58987808227539
randomsurplus_0,19,4,48,-29,5.9009528160095215,34.90095138549805
randomsurplus_0,19,5,48,-29,5.01828670501709,34.018287658691406
randomsurplus_0,19,6,48,-29,8.8778657913208,37.877864837646484
randomsurplus_0,19,7,48,-29,14.147688865661621,43.14768981933594
randomsurplus_1,41,1,48,-7,-3.7299211025238037,3.2700788974761963
randomsurplus_2,20,1,40,-20,-4.860729694366455,15.139270782470703
randomsurplus_2,20,2,35,-15,-1.5111815929412842,13.488818168640137
randomsurplus_2,20,3,33,-13,8.807775497436523,21.807775497436523
randomsurplus_2,20,4,42,-22,-12.454602241516113,9.545397758483887
randomsurplus_2,20,5,30,-10,9.951480865478516,19.951480865478516
randomsurplus_2,20,6,40,-20,5.48940896987915,25.489408493041992
randomsurplus_2,20,7,45,-25,-16.263742446899414,8.736257553100586
randomsurplus_3,29,1,48,-19,-6.236874580383301,12.7631254196167
randomsurplus_3,29,2,42,-13,-3.2357051372528076,9.764294624328613
randomsurplus_3,29,3,39,-10,-3.7376363277435303,6.262363433837891
randomsurplus_3,29,4,35,-6,-0.8978962302207947,5.1021037101745605
randomsurplus_3,29,5,34,-5,2.8851478099823,7.885148048400879
randomsurplus_3,29,6,37,-8,1.7092015743255615,9.70920181274414
randomsurplus_3,29,7,39,-10,-4.967247009277344,5.032752990722656
randomsurplus_4,29,1,48,-19,-15.922562599182129,3.077437400817871
randomsurplus_5,21,1,41,-20,-7.671935558319092,12.32806396484375
randomsurplus_5,21,2,33,-12,1.2110899686813354,13.211090087890625
randomsurplus_5,21,3,34,-13,-7.595286846160889,5.404713153839111
randomsurplus_5,21,4,26,-5,-4.3888840675354,0.6111159324645996
randomsurplus_6,22,1,42,-20,-5.128641605377197,14.871358871459961
randomsurplus_6,22,2,37,-15,-4.91259765625,10.08740234375
randomsurplus_6,22,3,32,-10,-7.217411518096924,2.782588481903076
randomsurplus_7,22,1,42,-20,4.526068210601807,24.52606773376465
randomsurplus_7,22,2,47,-25,-2.763828992843628,22.23617172241211
randomsurplus_7,22,3,44,-22,-12.269387245178223,9.730612754821777
randomsurplus_7,22,4,32,-10,-1.2974270582199097,8.7025728225708
randomsurplus_7,22,5,31,-9,-0.4967239797115326,8.503275871276855
randomsurplus_7,22,6,31,-9,8.18738079071045,17.187381744384766
randomsurplus_7,22,7,39,-17,-10.1594820022583,6.840517997741699
randomsurplus_8,28,1,48,-20,-4.9388346672058105,15.061164855957031
randomsurplus_8,28,2,43,-15,2.8279290199279785,17.82792854309082
randomsurplus_8,28,3,46,-18,-9.25596809387207,8.74403190612793
randomsurplus_8,28,4,37,-9,-9.441732406616211,0.44173240661621094
randomsurplus_9,28,1,48,-20,-12.11411190032959,7.88588809967041
randomsurplus_9,28,2,36,-8,1.6920862197875977,9.692086219787598
randomsurplus_9,28,3,38,-10,-5.01502799987793,4.98497200012207
secondfloorbalcony_0,32,1,48,-16,-12.52395248413086,3.4760475158691406
secondfloorbalcony_1,34,1,48,-14,-13.480981826782227,0.5190181732177734
secondfloorbalcony_3,20,1,40,-20,-11.962364196777344,8.037635803222656
secondfloorbalcony_3,20,2,28,-8,-12.034034729003906,4.034034729003906
secondfloorbalcony_4,23,1,43,-20,6.858922958374023,26.858922958374023
secondfloorbalcony_4,23,2,48,-25,14.621577262878418,39.621578216552734
secondfloorbalcony_4,23,3,48,-25,25.54360008239746,50.543601989746094
secondfloorbalcony_4,23,4,48,-25,8.575600624084473,33.575599670410156
secondfloorbalcony_4,23,5,48,-25,21.215707778930664,46.21570587158203
secondfloorbalcony_4,23,6,48,-25,25.657859802246094,50.657859802246094
secondfloorbalcony_4,23,7,48,-25,21.30716896057129,46.307167053222656
secondfloorbalcony_6,23,1,43,-20,-19.494401931762695,0.5055980682373047
secondfloorbalcony_7,19,1,39,-20,-3.9760499000549316,16.023950576782227
secondfloorbalcony_7,19,2,35,-16,-29.715551376342773,13.715551376342773
secondfloorbalcony_7,19,3,5,14,7.487553119659424,6.512446880340576
secondfloorbalcony_7,19,4,12,7,0.9210156202316284,6.078984260559082
secondfloorbalcony_7,19,5,13,6,-0.9866684675216675,6.986668586730957
secondfloorbalcony_7,19,6,12,7,3.0019803047180176,3.9980196952819824
secondfloorbalcony_8,19,1,39,-20,25.92070198059082,45.92070007324219
secondfloorbalcony_8,19,2,48,-29,-7.9625725746154785,21.03742790222168
secondfloorbalcony_8,19,3,40,-21,0.23634330928325653,21.236343383789062
secondfloorbalcony_8,19,4,40,-21,-3.341801166534424,17.658199310302734
secondfloorbalcony_8,19,5,37,-18,-9.523462295532227,8.476537704467773
secondfloorbalcony_8,19,6,27,-8,-5.890965461730957,2.109034538269043
secondfloorbalcony_9,21,1,41,-20,-21.275142669677734,1.2751426696777344
tableroom_0,19,1,39,-20,-11.578272819519043,8.421727180480957
tableroom_0,19,2,27,-8,-5.69561243057251,2.3043875694274902
tableroom_1,22,1,42,-20,-14.831208229064941,5.168791770935059
tableroom_1,22,2,27,-5,-8.768851280212402,3.7688512802124023
tableroom_2,44,1,48,-4,34.162071228027344,38.162071228027344
tableroom_2,44,2,48,-4,27.662160873413086,31.662160873413086
tableroom_2,44,3,48,-4,31.705541610717773,35.705543518066406
tableroom_2,44,4,48,-4,25.47506332397461,29.47506332397461
tableroom_2,44,5,48,-4,37.87416458129883,41.87416458129883
tableroom_2,44,6,48,-4,33.15964889526367,37.15964889526367
tableroom_2,44,7,48,-4,33.990081787109375,37.990081787109375
tableroom_3,33,1,48,-15,-8.212508201599121,6.787491798400879
tableroom_3,33,2,40,-7,2.167348861694336,9.167348861694336
tableroom_3,33,3,42,-9,-8.166807174682617,0.8331928253173828
tableroom_4,45,1,48,-3,0.07906048744916916,3.0790605545043945
tableroom_5,33,1,48,-15,-18.086795806884766,3.0867958068847656
