filename,CorrectPosition,focus_time,index,label,pred,loss
home1_0,29,1,0,29,48.41175079345703,19.41175079345703
home1_0,29,2,48,-19,47.109718322753906,66.1097183227539
home1_0,29,3,48,-19,-6.859975337982178,12.140024185180664
home1_0,29,4,41,-12,-0.2513280510902405,11.748671531677246
home1_0,29,5,41,-12,51.1270751953125,63.1270751953125
home1_0,29,6,48,-19,-10.47032642364502,8.52967357635498
home1_0,29,7,38,-9,0.17997446656227112,9.179974555969238
home1_1,23,1,0,23,17.016372680664062,5.9836273193359375
home1_1,23,2,17,6,-0.30692192912101746,6.30692195892334
home1_1,23,3,17,6,-2.6574854850769043,8.657485961914062
home1_1,23,4,14,9,6.9430952072143555,2.0569047927856445
home1_2,37,1,7,30,22.728349685668945,7.271650314331055
home1_2,37,2,30,7,3.933580160140991,3.066419839859009
home1_2,37,3,34,3,1.4235482215881348,1.5764517784118652
home1_3,32,1,2,30,15.319249153137207,14.680750846862793
home1_3,32,2,17,15,6.582486629486084,8.417512893676758
home1_3,32,3,24,8,-5.035985946655273,13.035985946655273
home1_3,32,4,19,13,14.505853652954102,1.5058536529541016
home1_4,47,1,17,30,7.453176975250244,22.546823501586914
home1_4,47,2,24,23,9.969572067260742,13.030427932739258
home1_4,47,3,34,13,4.069018840789795,8.930980682373047
home1_4,47,4,38,9,6.906599521636963,2.093400478363037
home1_5,47,1,17,30,24.88471794128418,5.11528205871582
home1_5,47,2,42,5,2.949319362640381,2.050680637359619
home1_6,34,1,4,30,27.696557998657227,2.3034420013427734
home1_8,29,1,0,29,8.643470764160156,20.356529235839844
home1_8,29,2,9,20,12.881429672241211,7.118570327758789
home1_8,29,3,22,7,3.0708200931549072,3.9291799068450928
home1_8,29,4,25,4,2.188044309616089,1.8119556903839111
home1_9,26,1,0,26,-3.130028486251831,29.130027770996094
home1_9,26,2,0,26,5.057065963745117,20.942934036254883
home1_9,26,3,5,21,13.145058631896973,7.854941368103027
home1_9,26,4,18,8,14.985474586486816,6.985474586486816
home1_9,26,5,33,-7,-11.593469619750977,4.593469619750977
home1_9,26,6,21,5,-6.554844379425049,11.55484390258789
home1_9,26,7,14,12,2.8829119205474854,9.117088317871094
home2_0,38,1,8,30,26.523475646972656,3.4765243530273438
home2_0,38,2,35,3,3.933108329772949,0.9331083297729492
home2_2,43,1,13,30,5.3784356117248535,24.621564865112305
home2_2,43,2,18,25,-2.0894768238067627,27.0894775390625
home2_2,43,3,16,27,-1.9066709280014038,28.90667152404785
home2_2,43,4,14,29,5.292200088500977,23.707799911499023
home2_2,43,5,19,24,9.154829025268555,14.845170974731445
home2_2,43,6,28,15,1.580112099647522,13.41988754272461
home2_2,43,7,30,13,1.7984223365783691,11.201578140258789
home2_3,31,1,1,30,6.732264995574951,23.26773452758789
home2_3,31,2,8,23,8.844045639038086,14.155954360961914
home2_3,31,3,17,14,4.091309070587158,9.90869140625
home2_3,31,4,21,10,2.5006051063537598,7.49939489364624
home2_3,31,5,24,7,4.00261116027832,2.9973888397216797
home2_4,34,1,4,30,3.731905698776245,26.268095016479492
home2_4,34,2,8,26,1.3831170797348022,24.61688232421875
home2_4,34,3,9,25,0.5430312752723694,24.456968307495117
home2_4,34,4,10,24,-0.9878151416778564,24.987815856933594
home2_4,34,5,9,25,3.3554129600524902,21.64458656311035
home2_4,34,6,12,22,3.3674416542053223,18.632558822631836
home2_4,34,7,15,19,-2.8744795322418213,21.874479293823242
home2_5,30,1,0,30,8.408493995666504,21.591506958007812
home2_5,30,2,8,22,14.43864631652832,7.56135368347168
home2_5,30,3,22,8,15.076812744140625,7.076812744140625
home2_5,30,4,37,-7,2.0769717693328857,9.076972007751465
home2_5,30,5,39,-9,-1.4661842584609985,7.533815860748291
home2_5,30,6,38,-8,0.6344960331916809,8.634495735168457
home2_5,30,7,39,-9,0.3415074348449707,9.341506958007812
home2_6,29,1,0,29,21.553890228271484,7.446109771728516
home2_6,29,2,22,7,6.0851826667785645,0.9148173332214355
home2_7,34,1,4,30,11.94499683380127,18.055004119873047
home2_7,34,2,16,18,3.482342481613159,14.517657279968262
home2_7,34,3,19,15,7.630364418029785,7.369635581970215
home2_7,34,4,27,7,4.673243522644043,2.326756477355957
home2_9,30,1,0,30,26.1445369720459,3.8554630279541016
home2_9,30,2,26,4,8.597582817077637,4.597582817077637
home2_9,30,3,35,-5,-0.24826212227344513,4.75173807144165
home2_9,30,4,35,-5,2.7100257873535156,7.710025787353516
home2_9,30,5,38,-8,-3.459468126296997,4.540532112121582
home2_9,30,6,35,-5,-0.781804621219635,4.21819543838501
home2_9,30,7,34,-4,2.406904697418213,6.406904697418213
microkitchen1_0,21,1,0,21,16.336111068725586,4.663888931274414
microkitchen1_0,21,2,16,5,-1.6163665056228638,6.616366386413574
microkitchen1_0,21,3,14,7,-3.3462026119232178,10.346202850341797
microkitchen1_0,21,4,11,10,1.6356288194656372,8.364371299743652
microkitchen1_0,21,5,13,8,5.122365951538086,2.877634048461914
microkitchen1_1,21,1,0,21,17.345500946044922,3.654499053955078
microkitchen1_1,21,2,17,4,-0.8299955725669861,4.829995632171631
microkitchen1_1,21,3,16,5,-2.741589069366455,7.741589069366455
microkitchen1_1,21,4,13,8,5.025583267211914,2.974416732788086
microkitchen1_2,21,1,0,21,41.81294631958008,20.812946319580078
microkitchen1_2,21,2,42,-21,-15.80595588684082,5.19404411315918
microkitchen1_2,21,3,26,-5,-3.6906871795654297,1.3093128204345703
microkitchen1_3,24,1,0,24,14.780096054077148,9.219903945922852
microkitchen1_3,24,2,15,9,7.206284046173096,1.7937159538269043
microkitchen1_4,25,1,0,25,23.160457611083984,1.8395423889160156
microkitchen1_5,25,1,0,25,42.44063949584961,17.44063949584961
microkitchen1_5,25,2,42,-17,-6.973932266235352,10.026067733764648
microkitchen1_5,25,3,35,-10,-9.763689994812012,0.23631000518798828
microkitchen1_6,25,1,0,25,12.531462669372559,12.468537330627441
microkitchen1_6,25,2,13,12,8.20971393585205,3.790286064147949
microkitchen1_6,25,3,21,4,-0.8017539978027344,4.801753997802734
microkitchen1_6,25,4,20,5,1.837914228439331,3.162085771560669
microkitchen1_6,25,5,22,3,3.683432102203369,0.6834321022033691
microkitchen1_7,20,1,0,20,9.258451461791992,10.741548538208008
microkitchen1_7,20,2,9,11,1.7050962448120117,9.294903755187988
microkitchen1_7,20,3,11,9,0.1134364977478981,8.886563301086426
microkitchen1_7,20,4,11,9,-1.8136061429977417,10.813606262207031
microkitchen1_7,20,5,9,11,1.0410281419754028,9.958971977233887
microkitchen1_7,20,6,10,10,4.348021030426025,5.651978969573975
microkitchen1_7,20,7,14,6,-7.191649913787842,13.191650390625
microkitchen1_8,29,1,0,29,43.29810333251953,14.298103332519531
microkitchen1_8,29,2,43,-14,-5.836167812347412,8.16383171081543
microkitchen1_8,29,3,37,-8,-4.481256484985352,3.5187435150146484
microkitchen1_8,29,4,33,-4,-2.0001344680786133,1.9998655319213867
microkitchen1_9,19,1,0,19,10.065226554870605,8.934773445129395
microkitchen1_9,19,2,10,9,4.60066556930542,4.39933443069458
microkitchen1_9,19,3,15,4,4.583641529083252,0.583641529083252
pillowroom1_0,25,1,0,25,22.392925262451172,2.607074737548828
pillowroom1_6,27,1,0,27,38.59846115112305,11.598461151123047
pillowroom1_6,27,2,39,-12,-4.1807451248168945,7.8192548751831055
pillowroom1_6,27,3,35,-8,4.389891624450684,12.389891624450684
pillowroom1_6,27,4,39,-12,-3.327523946762085,8.672475814819336
pillowroom1_6,27,5,36,-9,3.3645639419555664,12.364563941955566
pillowroom1_6,27,6,39,-12,3.8029680252075195,15.80296802520752
pillowroom1_6,27,7,43,-16,-6.642662048339844,9.357337951660156
pillowroom1_7,36,1,6,30,29.575374603271484,0.4246253967285156
pillowroom1_8,34,1,4,30,21.277551651000977,8.722448348999023
pillowroom1_8,34,2,25,9,7.674914360046387,1.3250856399536133
pillowroom1_9,21,1,0,21,6.153550148010254,14.846449851989746
pillowroom1_9,21,2,6,15,3.1178929805755615,11.88210678100586
pillowroom1_9,21,3,9,12,1.1407421827316284,10.859257698059082
pillowroom1_9,21,4,10,11,8.100472450256348,2.8995275497436523
secondfloorgames_0,20,1,0,20,16.47627067565918,3.5237293243408203
secondfloorgames_0,20,2,16,4,-0.07642173022031784,4.076421737670898
secondfloorgames_0,20,3,16,4,0.6705772876739502,3.32942271232605
secondfloorgames_0,20,4,17,3,-1.6214959621429443,4.621496200561523
secondfloorgames_0,20,5,15,5,-0.16181741654872894,5.16181755065918
secondfloorgames_0,20,6,15,5,3.8506646156311035,1.1493353843688965
secondfloorgames_1,24,1,0,24,0.940741777420044,23.05925750732422
secondfloorgames_1,24,2,1,23,0.28768131136894226,22.712318420410156
secondfloorgames_1,24,3,1,23,1.2700016498565674,21.729997634887695
secondfloorgames_1,24,4,2,22,11.269994735717773,10.730005264282227
secondfloorgames_1,24,5,13,11,0.2066746950149536,10.793325424194336
secondfloorgames_1,24,6,13,11,11.535577774047852,0.5355777740478516
secondfloorgames_2,30,1,0,30,17.86925506591797,12.130744934082031
secondfloorgames_2,30,2,18,12,7.161818504333496,4.838181495666504
secondfloorgames_2,30,3,25,5,-3.2479357719421387,8.247936248779297
secondfloorgames_2,30,4,22,8,-6.506631374359131,14.506631851196289
secondfloorgames_2,30,5,15,15,12.596704483032227,2.4032955169677734
secondfloorgames_3,23,1,0,23,24.617963790893555,1.6179637908935547
secondfloorgames_4,22,1,0,22,10.534546852111816,11.465453147888184
secondfloorgames_4,22,2,11,11,8.720612525939941,2.2793874740600586
secondfloorgames_5,24,1,0,24,19.152572631835938,4.8474273681640625
secondfloorgames_5,24,2,19,5,4.596374988555908,0.4036250114440918
secondfloorgames_6,19,1,0,19,22.795448303222656,3.7954483032226562
secondfloorgames_6,19,2,23,-4,10.761636734008789,14.761636734008789
secondfloorgames_6,19,3,34,-15,-8.906167030334473,6.093832969665527
secondfloorgames_6,19,4,25,-6,23.03050422668457,29.03050422668457
secondfloorgames_6,19,5,48,-29,1.8362466096878052,30.836246490478516
secondfloorgames_6,19,6,48,-29,7.096553325653076,36.096553802490234
secondfloorgames_6,19,7,48,-29,-25.20695686340332,3.7930431365966797
secondfloorgames_7,20,1,0,20,16.604459762573242,3.395540237426758
secondfloorgames_7,20,2,17,3,7.721101760864258,4.721101760864258
secondfloorgames_7,20,3,25,-5,4.329519271850586,9.329519271850586
secondfloorgames_7,20,4,29,-9,-9.119229316711426,0.11922931671142578
secondfloorgames_8,23,1,0,23,14.944862365722656,8.055137634277344
secondfloorgames_8,23,2,15,8,5.736783981323242,2.263216018676758
apt1_0,25,1,0,25,30.53575325012207,5.53575325012207
apt1_0,25,2,31,-6,-12.377313613891602,6.377313613891602
apt1_0,25,3,19,6,1.4447219371795654,4.5552778244018555
apt1_0,25,4,20,5,-2.8267710208892822,7.826770782470703
apt1_0,25,5,17,8,4.540391445159912,3.459608554840088
apt1_0,25,6,22,3,-0.4477088451385498,3.44770884513855
apt1_0,25,7,22,3,-7.318270206451416,10.318269729614258
apt1_1,21,1,0,21,16.060150146484375,4.939849853515625
apt1_1,21,2,16,5,2.8546221256256104,2.1453778743743896
apt1_2,24,1,0,24,18.65719985961914,5.342800140380859
apt1_2,24,2,19,5,-1.7314058542251587,6.731405735015869
apt1_2,24,3,17,7,-1.5029306411743164,8.502930641174316
apt1_2,24,4,15,9,1.3800337314605713,7.619966506958008
apt1_2,24,5,16,8,0.21701373159885406,7.782986164093018
apt1_2,24,6,16,8,0.4632863998413086,7.536713600158691
apt1_2,24,7,16,8,0.41823944449424744,7.581760406494141
apt1_3,25,1,0,25,12.266977310180664,12.733022689819336
apt1_3,25,2,12,13,10.532870292663574,2.467129707336426
apt1_4,23,1,0,23,5.187314987182617,17.812685012817383
apt1_4,23,2,5,18,1.9902095794677734,16.009790420532227
apt1_4,23,3,7,16,1.4773859977722168,14.522613525390625
apt1_4,23,4,8,15,3.956726551055908,11.04327392578125
apt1_4,23,5,12,11,1.0079013109207153,9.992098808288574
apt1_4,23,6,13,10,3.832702875137329,6.16729736328125
apt1_4,23,7,17,6,4.960955619812012,1.0390443801879883
apt1_5,22,1,0,22,9.05822467803955,12.94177532196045
apt1_5,22,2,9,13,1.9649204015731812,11.035079956054688
apt1_5,22,3,11,11,3.409255266189575,7.590744972229004
apt1_5,22,4,14,8,0.30142942070961,7.698570728302002
apt1_5,22,5,14,8,2.038008451461792,5.961991310119629
apt1_5,22,6,16,6,-0.11866863816976547,6.118668556213379
apt1_5,22,7,16,6,2.901196002960205,3.098803997039795
apt1_6,20,1,0,20,20.438499450683594,0.43849945068359375
apt1_7,20,1,0,20,6.291472911834717,13.708526611328125
apt1_7,20,2,6,14,8.704556465148926,5.295443534851074
apt1_7,20,3,15,5,2.6191253662109375,2.3808746337890625
apt1_8,31,1,1,30,33.49885559082031,3.4988555908203125
apt1_8,31,2,34,-3,5.084929466247559,8.084929466247559
apt1_8,31,3,39,-8,4.629206657409668,12.629206657409668
apt1_8,31,4,44,-13,2.0481245517730713,15.048124313354492
apt1_8,31,5,46,-15,-12.446834564208984,2.5531654357910156
apt1_9,20,1,0,20,17.461273193359375,2.538726806640625
apt2_0,41,1,11,30,23.676342010498047,6.323657989501953
apt2_0,41,2,35,6,6.4967360496521,0.4967360496520996
apt2_1,20,1,0,20,11.934956550598145,8.065043449401855
apt2_1,20,2,12,8,6.69580078125,1.30419921875
apt2_2,23,1,0,23,8.250489234924316,14.749510765075684
apt2_2,23,2,8,15,13.130163192749023,1.8698368072509766
apt2_3,26,1,0,26,5.499493598937988,20.500507354736328
apt2_3,26,2,5,21,13.09330940246582,7.90669059753418
apt2_3,26,3,18,8,6.3290534019470215,1.6709465980529785
apt2_4,23,1,0,23,18.61814308166504,4.381856918334961
apt2_4,23,2,19,4,1.761859655380249,2.238140344619751
apt2_5,26,1,0,26,11.050064086914062,14.949935913085938
apt2_5,26,2,11,15,8.29295539855957,6.70704460144043
apt2_5,26,3,19,7,4.114749908447266,2.8852500915527344
apt2_6,23,1,0,23,-5.744030952453613,28.744029998779297
apt2_6,23,2,0,23,-0.3646664619445801,23.364665985107422
apt2_6,23,3,0,23,-4.301647186279297,27.301647186279297
apt2_6,23,4,0,23,1.1325856447219849,21.867414474487305
apt2_6,23,5,1,22,2.03753924369812,19.962461471557617
apt2_6,23,6,3,20,10.251922607421875,9.748077392578125
apt2_6,23,7,13,10,6.2788872718811035,3.7211127281188965
apt2_7,31,1,1,30,28.622339248657227,1.3776607513427734
apt2_8,40,1,10,30,14.694246292114258,15.305753707885742
apt2_8,40,2,25,15,8.112589836120605,6.8874101638793945
apt2_8,40,3,33,7,3.4366331100463867,3.5633668899536133
apt2_8,40,4,36,4,7.249820709228516,3.2498207092285156
apt2_8,40,5,43,-3,-0.2480856478214264,2.7519142627716064
apt2_9,24,1,0,24,21.96576499938965,2.0342350006103516
books_0,27,1,0,27,27.364917755126953,0.3649177551269531
books_1,26,1,0,26,2.166015386581421,23.833984375
books_1,26,2,2,24,9.626696586608887,14.373303413391113
books_1,26,3,12,14,6.628228664398193,7.371771335601807
books_1,26,4,19,7,9.369040489196777,2.3690404891967773
books_2,22,1,0,22,7.883867263793945,14.116132736206055
books_2,22,2,8,14,6.669376373291016,7.330623626708984
books_2,22,3,15,7,0.2165023237466812,6.7834978103637695
books_2,22,4,15,7,5.292907238006592,1.7070927619934082
books_3,23,1,0,23,21.057861328125,1.942138671875
books_4,24,1,0,24,19.86448097229004,4.135519027709961
books_4,24,2,20,4,4.211913585662842,0.2119135856628418
books_5,22,1,0,22,10.198443412780762,11.801556587219238
books_5,22,2,10,12,8.912605285644531,3.0873947143554688
books_5,22,3,19,3,0.04308922961354256,2.9569108486175537
books_6,20,1,0,20,12.109525680541992,7.890474319458008
books_6,20,2,12,8,5.767937183380127,2.232062816619873
books_7,26,1,0,26,4.3966546058654785,21.60334587097168
books_7,26,2,4,22,3.6449403762817383,18.355060577392578
books_7,26,3,8,18,3.9439609050750732,14.056038856506348
books_7,26,4,12,14,4.34929895401001,9.650701522827148
books_7,26,5,16,10,4.7682976722717285,5.2317023277282715
books_7,26,6,21,5,6.47731876373291,1.4773187637329102
books_8,23,1,0,23,2.5696239471435547,20.430376052856445
books_8,23,2,3,20,6.192351341247559,13.807648658752441
books_8,23,3,9,14,2.427241563796997,11.572758674621582
books_8,23,4,11,12,-0.18367798626422882,12.183677673339844
books_8,23,5,11,12,3.6273581981658936,8.372641563415527
books_8,23,6,15,8,2.2167088985443115,5.783290863037109
books_8,23,7,17,6,5.630481719970703,0.3695182800292969
books_9,27,1,0,27,30.89207649230957,3.8920764923095703
books_9,27,2,31,-4,2.3554000854492188,6.355400085449219
books_9,27,3,33,-6,-1.7870630025863647,4.212936878204346
books_9,27,4,31,-4,0.9915615916252136,4.991561412811279
books_9,27,5,32,-5,-5.199611663818359,0.19961166381835938
bottles_0,22,1,0,22,9.004110336303711,12.995889663696289
bottles_0,22,2,9,13,8.778044700622559,4.221955299377441
bottles_0,22,3,18,4,4.57521915435791,0.5752191543579102
bottles_1,23,1,0,23,6.329801559448242,16.670198440551758
bottles_1,23,2,6,17,6.7225518226623535,10.277448654174805
bottles_1,23,3,13,10,2.240070104598999,7.759929656982422
bottles_1,23,4,15,8,3.246272087097168,4.753727912902832
bottles_1,23,5,18,5,5.03386926651001,0.033869266510009766
bottles_2,22,1,0,22,31.23136329650879,9.231363296508789
bottles_2,22,2,31,-9,-15.302968978881836,6.302968978881836
bottles_2,22,3,16,6,3.78482723236084,2.21517276763916
bottles_3,30,1,0,30,20.13710594177246,9.862894058227539
bottles_3,30,2,20,10,18.759796142578125,8.759796142578125
bottles_3,30,3,39,-9,17.82381820678711,26.82381820678711
bottles_3,30,4,48,-18,-5.682310581207275,12.317689895629883
bottles_3,30,5,42,-12,11.716513633728027,23.716514587402344
bottles_3,30,6,48,-18,1.2378475666046143,19.23784828186035
bottles_3,30,7,48,-18,8.393244743347168,26.393245697021484
bottles_4,25,1,0,25,36.93874740600586,11.93874740600586
bottles_4,25,2,37,-12,-7.356000900268555,4.643999099731445
bottles_4,25,3,30,-5,3.4493134021759033,8.449313163757324
bottles_4,25,4,33,-8,-1.1154223680496216,6.884577751159668
bottles_4,25,5,32,-7,-3.1290018558502197,3.8709981441497803
bottles_4,25,6,29,-4,1.8677037954330444,5.867703914642334
bottles_4,25,7,31,-6,-1.3020949363708496,4.69790506362915
bottles_5,27,1,0,27,22.32941436767578,4.670585632324219
bottles_5,27,2,22,5,4.274942398071289,0.7250576019287109
bottles_6,27,1,0,27,13.56287670135498,13.43712329864502
bottles_6,27,2,14,13,6.157233238220215,6.842766761779785
bottles_6,27,3,20,7,3.2324087619781494,3.7675912380218506
bottles_6,27,4,23,4,2.5009987354278564,1.4990012645721436
bottles_7,27,1,0,27,14.19699478149414,12.80300521850586
bottles_7,27,2,14,13,18.98999786376953,5.989997863769531
bottles_7,27,3,33,-6,-1.3512564897537231,4.648743629455566
bottles_7,27,4,32,-5,-12.883638381958008,7.883638381958008
bottles_7,27,5,19,8,10.88337230682373,2.8833723068237305
bottles_8,25,1,0,25,15.63149356842041,9.36850643157959
bottles_8,25,2,16,9,12.829771041870117,3.829771041870117
bottles_8,25,3,29,-4,-8.416556358337402,4.416556358337402
bottles_8,25,4,21,4,5.120788097381592,1.1207880973815918
campusoutdoors1_0,20,1,0,20,13.056455612182617,6.943544387817383
campusoutdoors1_0,20,2,13,7,1.8955820798873901,5.10441780090332
campusoutdoors1_0,20,3,15,5,-3.443140745162964,8.443140983581543
campusoutdoors1_0,20,4,12,8,-6.710258483886719,14.710258483886719
campusoutdoors1_0,20,5,5,15,7.0353102684021,7.9646897315979
campusoutdoors1_0,20,6,12,8,6.083863735198975,1.9161362648010254
campusoutdoors1_1,20,1,0,20,21.863243103027344,1.8632431030273438
campusoutdoors1_2,22,1,0,22,25.56242561340332,3.5624256134033203
campusoutdoors1_2,22,2,26,-4,-13.818707466125488,9.818707466125488
campusoutdoors1_2,22,3,12,10,4.340625286102295,5.659374713897705
campusoutdoors1_2,22,4,16,6,1.2359369993209839,4.764062881469727
campusoutdoors1_2,22,5,17,5,4.867492198944092,0.1325078010559082
campusoutdoors1_3,20,1,0,20,10.276761054992676,9.723238945007324
campusoutdoors1_3,20,2,10,10,-2.05068302154541,12.05068302154541
campusoutdoors1_3,20,3,8,12,1.868053913116455,10.131946563720703
campusoutdoors1_3,20,4,10,10,-2.6229708194732666,12.622970581054688
campusoutdoors1_3,20,5,7,13,2.7722020149230957,10.227798461914062
campusoutdoors1_3,20,6,10,10,4.785932540893555,5.214067459106445
campusoutdoors1_3,20,7,15,5,-4.261221885681152,9.261221885681152
campusoutdoors1_4,22,1,0,22,10.27485466003418,11.72514533996582
campusoutdoors1_4,22,2,10,12,4.2033305168151855,7.7966694831848145
campusoutdoors1_4,22,3,14,8,4.201892375946045,3.798107624053955
campusoutdoors1_4,22,4,18,4,-3.254420757293701,7.254420757293701
campusoutdoors1_4,22,5,15,7,4.235438346862793,2.764561653137207
campusoutdoors1_5,22,1,0,22,14.680830001831055,7.319169998168945
campusoutdoors1_5,22,2,15,7,-5.437678813934326,12.437679290771484
campusoutdoors1_5,22,3,10,12,8.37816333770752,3.6218366622924805
campusoutdoors1_5,22,4,18,4,3.003340482711792,0.996659517288208
campusoutdoors1_6,27,1,0,27,30.736106872558594,3.7361068725585938
campusoutdoors1_6,27,2,31,-4,4.970256805419922,8.970256805419922
campusoutdoors1_6,27,3,36,-9,-2.129913091659546,6.870086669921875
campusoutdoors1_6,27,4,34,-7,-1.0135959386825562,5.986403942108154
campusoutdoors1_6,27,5,33,-6,0.024031510576605797,6.024031639099121
campusoutdoors1_6,27,6,33,-6,-1.3982579708099365,4.601741790771484
campusoutdoors1_6,27,7,32,-5,-2.387976884841919,2.612023115158081
campusoutdoors1_8,19,1,0,19,6.5328688621521,12.467130661010742
campusoutdoors1_8,19,2,7,12,4.18821907043457,7.81178092956543
campusoutdoors1_8,19,3,11,8,-1.8666189908981323,9.866619110107422
campusoutdoors1_8,19,4,9,10,2.212238311767578,7.787761688232422
campusoutdoors1_8,19,5,11,8,2.7979302406311035,5.2020697593688965
campusoutdoors1_8,19,6,14,5,-3.101740598678589,8.101740837097168
campusoutdoors1_8,19,7,11,8,2.106149435043335,5.893850326538086
campusoutdoors1_9,19,1,0,19,7.244348049163818,11.755651473999023
campusoutdoors1_9,19,2,7,12,4.258051872253418,7.741948127746582
campusoutdoors1_9,19,3,11,8,4.6132965087890625,3.3867034912109375
campusoutdoors1_9,19,4,16,3,20.717435836791992,17.717435836791992
campusoutdoors1_9,19,5,37,-18,8.658275604248047,26.658275604248047
campusoutdoors1_9,19,6,46,-27,1.8865301609039307,28.88652992248535
campusoutdoors1_9,19,7,48,-29,5.174055576324463,34.17405700683594
campusoutdoors2_0,20,1,0,20,5.748237133026123,14.251762390136719
campusoutdoors2_0,20,2,6,14,3.162510871887207,10.837489128112793
campusoutdoors2_0,20,3,9,11,-0.04651349410414696,11.046513557434082
campusoutdoors2_0,20,4,9,11,-0.6963317394256592,11.696331977844238
campusoutdoors2_0,20,5,8,12,1.2789398431777954,10.721059799194336
campusoutdoors2_0,20,6,9,11,0.1441936045885086,10.855806350708008
campusoutdoors2_0,20,7,9,11,-1.913191318511963,12.913190841674805
campusoutdoors2_1,42,1,12,30,22.21159553527832,7.78840446472168
campusoutdoors2_1,42,2,34,8,5.325827598571777,2.6741724014282227
campusoutdoors2_3,31,1,1,30,16.024099349975586,13.975900650024414
campusoutdoors2_3,31,2,17,14,5.900415897369385,8.099584579467773
campusoutdoors2_3,31,3,23,8,2.1575369834899902,5.84246301651001
campusoutdoors2_3,31,4,25,6,2.2130696773529053,3.7869303226470947
campusoutdoors2_3,31,5,27,4,-0.3242705762386322,4.324270725250244
campusoutdoors2_3,31,6,27,4,-4.386837005615234,8.386837005615234
campusoutdoors2_3,31,7,23,8,3.2938671112060547,4.706132888793945
campusoutdoors2_4,29,1,0,29,31.13648796081543,2.1364879608154297
campusoutdoors2_5,32,1,2,30,22.125988006591797,7.874011993408203
campusoutdoors2_5,32,2,24,8,6.7030930519104,1.2969069480895996
campusoutdoors2_6,22,1,0,22,17.122060775756836,4.877939224243164
campusoutdoors2_6,22,2,17,5,8.591344833374023,3.5913448333740234
campusoutdoors2_6,22,3,26,-4,-4.589917182922363,0.5899171829223633
campusoutdoors2_7,23,1,0,23,14.778153419494629,8.221846580505371
campusoutdoors2_7,23,2,15,8,-3.282963514328003,11.282963752746582
campusoutdoors2_7,23,3,12,11,8.062535285949707,2.937464714050293
campusoutdoors2_8,23,1,0,23,15.861079216003418,7.138920783996582
campusoutdoors2_8,23,2,16,7,9.582411766052246,2.582411766052246
campusoutdoors2_9,25,1,0,25,17.66279411315918,7.33720588684082
campusoutdoors2_9,25,2,18,7,5.736740589141846,1.2632594108581543
fakeplants_0,24,1,0,24,8.301392555236816,15.698607444763184
fakeplants_0,24,2,8,16,8.027328491210938,7.9726715087890625
fakeplants_0,24,3,16,8,5.921730041503906,2.0782699584960938
fakeplants_1,21,1,0,21,11.703603744506836,9.296396255493164
fakeplants_1,21,2,12,9,7.176626205444336,1.823373794555664
fakeplants_2,21,1,0,21,10.076942443847656,10.923057556152344
fakeplants_2,21,2,10,11,6.701189994812012,4.298810005187988
fakeplants_2,21,3,17,4,-1.1202276945114136,5.120227813720703
fakeplants_2,21,4,16,5,1.3239938020706177,3.676006317138672
fakeplants_2,21,5,17,4,0.2449256181716919,3.7550745010375977
fakeplants_2,21,6,17,4,3.376964569091797,0.6230354309082031
fakeplants_3,22,1,0,22,7.262880802154541,14.737119674682617
fakeplants_3,22,2,7,15,5.663686752319336,9.336313247680664
fakeplants_3,22,3,13,9,2.607062578201294,6.392937660217285
fakeplants_3,22,4,16,6,2.940070152282715,3.059929847717285
fakeplants_3,22,5,19,3,1.9680618047714233,1.0319381952285767
fakeplants_4,24,1,0,24,31.590518951416016,7.590518951416016
fakeplants_4,24,2,32,-8,-11.201409339904785,3.201409339904785
fakeplants_4,24,3,21,3,2.4096479415893555,0.5903520584106445
fakeplants_5,21,1,0,21,47.950218200683594,26.950218200683594
fakeplants_5,21,2,48,-27,2.8817505836486816,29.881750106811523
fakeplants_5,21,3,48,-27,10.202139854431152,37.20214080810547
fakeplants_5,21,4,48,-27,3.4682939052581787,30.468294143676758
fakeplants_5,21,5,48,-27,12.87548542022705,39.875484466552734
fakeplants_5,21,6,48,-27,0.3199792206287384,27.319978713989258
fakeplants_5,21,7,48,-27,4.312435150146484,31.312435150146484
fakeplants_6,21,1,0,21,18.767776489257812,2.2322235107421875
fakeplants_7,23,1,0,23,30.848133087158203,7.848133087158203
fakeplants_7,23,2,31,-8,-2.050481081008911,5.949519157409668
fakeplants_7,23,3,29,-6,-1.435135006904602,4.5648651123046875
fakeplants_7,23,4,28,-5,-1.6203657388687134,3.379634380340576
fakeplants_7,23,5,26,-3,-2.4778945446014404,0.5221054553985596
fakeplants_8,21,1,0,21,18.76183319091797,2.2381668090820312
fakeplants_9,21,1,0,21,19.56500816345215,1.4349918365478516
garage2_0,22,1,0,22,22.025615692138672,0.025615692138671875
garage2_1,24,1,0,24,18.85112190246582,5.14887809753418
garage2_1,24,2,19,5,-0.7166459560394287,5.716646194458008
garage2_1,24,3,18,6,-0.7064251899719238,6.706425189971924
garage2_1,24,4,17,7,1.9129858016967773,5.087014198303223
garage2_1,24,5,19,5,2.982483386993408,2.017516613006592
garage2_2,31,1,1,30,19.757165908813477,10.242834091186523
garage2_2,31,2,21,10,22.10751724243164,12.10751724243164
garage2_2,31,3,43,-12,-4.279663562774658,7.720336437225342
garage2_2,31,4,39,-8,-3.532966375350952,4.467033386230469
garage2_2,31,5,35,-4,0.5701592564582825,4.570159435272217
garage2_2,31,6,36,-5,4.440176963806152,9.440176963806152
garage2_2,31,7,40,-9,-1.8081175088882446,7.191882610321045
garage2_4,24,1,0,24,33.50745391845703,9.507453918457031
garage2_4,24,2,34,-10,-10.179549217224121,0.1795492172241211
garage2_6,26,1,0,26,20.770116806030273,5.229883193969727
garage2_6,26,2,21,5,9.480390548706055,4.480390548706055
garage2_6,26,3,30,-4,12.098937034606934,16.09893798828125
garage2_6,26,4,42,-16,13.381451606750488,29.381450653076172
garage2_6,26,5,48,-22,8.58723258972168,30.58723258972168
garage2_6,26,6,48,-22,1.1612969636917114,23.161296844482422
garage2_6,26,7,48,-22,-0.7435421943664551,21.256458282470703
garage2_7,24,1,0,24,8.388540267944336,15.611459732055664
garage2_7,24,2,8,16,7.89458703994751,8.105413436889648
garage2_7,24,3,16,8,3.8259329795837402,4.17406702041626
garage2_7,24,4,20,4,3.2134897708892822,0.7865102291107178
garage2_8,21,1,0,21,15.035320281982422,5.964679718017578
garage2_8,21,2,15,6,2.9592978954315186,3.0407021045684814
garage2_8,21,3,18,3,-0.5633459687232971,3.5633459091186523
garage2_8,21,4,17,4,-3.3374252319335938,7.337425231933594
garage2_8,21,5,14,7,2.4244492053985596,4.5755510330200195
garage2_8,21,6,16,5,-1.356261134147644,6.356261253356934
garage2_8,21,7,15,6,-0.21468640863895416,6.214686393737793
garage2_9,23,1,0,23,10.9196195602417,12.0803804397583
garage2_9,23,2,11,12,-1.2137632369995117,13.213763236999512
garage2_9,23,3,10,13,0.4540865123271942,12.545913696289062
garage2_9,23,4,10,13,-2.2367048263549805,15.23670482635498
garage2_9,23,5,8,15,4.0989885330200195,10.90101146697998
garage2_9,23,6,12,11,2.067009210586548,8.932991027832031
garage2_9,23,7,14,9,-2.104146957397461,11.104146957397461
garage_0,25,1,0,25,15.203452110290527,9.796547889709473
garage_0,25,2,15,10,5.854841232299805,4.145158767700195
garage_0,25,3,21,4,2.8188316822052,1.1811683177947998
garage_1,27,1,0,27,1.9741466045379639,25.025854110717773
garage_1,27,2,2,25,0.7438920736312866,24.256107330322266
garage_1,27,3,3,24,1.273169755935669,22.726829528808594
garage_1,27,4,4,23,6.565624713897705,16.434375762939453
garage_1,27,5,11,16,2.1000187397003174,13.899981498718262
garage_1,27,6,13,14,4.214820861816406,9.785179138183594
garage_1,27,7,17,10,7.364406108856201,2.635593891143799
garage_3,22,1,0,22,11.522089004516602,10.477910995483398
garage_3,22,2,12,10,4.947703838348389,5.052296161651611
garage_3,22,3,17,5,1.9691548347473145,3.0308451652526855
garage_3,22,4,19,3,-2.264157772064209,5.264157772064209
garage_3,22,5,17,5,2.427626132965088,2.572373867034912
garage_4,44,1,14,30,13.049042701721191,16.950958251953125
garage_4,44,2,27,17,7.69517183303833,9.304828643798828
garage_4,44,3,35,9,0.985157310962677,8.014842987060547
garage_4,44,4,36,8,1.6579846143722534,6.342015266418457
garage_4,44,5,38,6,3.243136167526245,2.756863832473755
garage_6,27,1,0,27,11.755813598632812,15.244186401367188
garage_6,27,2,12,15,12.300491333007812,2.6995086669921875
garage_7,22,1,0,22,15.357748031616211,6.642251968383789
garage_7,22,2,15,7,6.439311504364014,0.5606884956359863
garage_8,44,1,14,30,37.006839752197266,7.006839752197266
garage_8,44,2,48,-4,-7.806175231933594,3.8061752319335938
garage_8,44,3,40,4,3.5099825859069824,0.4900174140930176
garage_9,20,1,0,20,12.844175338745117,7.155824661254883
garage_9,20,2,13,7,5.4181036949157715,1.5818963050842285
hallway1_0,32,1,2,30,17.26854133605957,12.73145866394043
hallway1_0,32,2,19,13,10.729907035827637,2.2700929641723633
hallway1_2,33,1,3,30,29.188751220703125,0.811248779296875
hallway1_3,26,1,0,26,9.409991264343262,16.590007781982422
hallway1_3,26,2,9,17,7.009010314941406,9.990989685058594
hallway1_3,26,3,16,10,5.6128363609313965,4.3871636390686035
hallway1_3,26,4,22,4,1.1728894710540771,2.827110528945923
hallway1_4,23,1,0,23,11.777316093444824,11.222683906555176
hallway1_4,23,2,12,11,7.42034912109375,3.57965087890625
hallway1_4,23,3,19,4,2.805300712585449,1.1946992874145508
hallway1_5,22,1,0,22,10.425214767456055,11.574785232543945
hallway1_5,22,2,10,12,5.183163642883301,6.816836357116699
hallway1_5,22,3,15,7,-0.422284871339798,7.422285079956055
hallway1_5,22,4,15,7,8.990544319152832,1.990544319152832
hallway1_6,22,1,0,22,8.953988075256348,13.046011924743652
hallway1_6,22,2,9,13,11.738933563232422,1.2610664367675781
hallway1_7,37,1,7,30,27.80877113342285,2.1912288665771484
hallway2_0,29,1,0,29,23.772668838500977,5.227331161499023
hallway2_0,29,2,24,5,19.609451293945312,14.609451293945312
hallway2_0,29,3,44,-15,-6.41618537902832,8.58381462097168
hallway2_0,29,4,38,-9,1.5720916986465454,10.572092056274414
hallway2_0,29,5,40,-11,1.474306583404541,12.474306106567383
hallway2_0,29,6,41,-12,0.8514419198036194,12.851442337036133
hallway2_0,29,7,42,-13,-1.001489520072937,11.998510360717773
hallway2_1,34,1,4,30,4.189263820648193,25.81073570251465
hallway2_1,34,2,8,26,0.45641618967056274,25.543582916259766
hallway2_1,34,3,8,26,4.240703105926514,21.759296417236328
hallway2_1,34,4,12,22,3.6863691806793213,18.313631057739258
hallway2_1,34,5,16,18,2.518684148788452,15.481315612792969
hallway2_1,34,6,19,15,3.6648969650268555,11.335103034973145
hallway2_1,34,7,23,11,2.6239452362060547,8.376054763793945
hallway2_2,25,1,0,25,22.193010330200195,2.8069896697998047
meetingroom1_7,19,1,0,19,17.942338943481445,1.0576610565185547
meetingroom1_8,21,1,0,21,14.540562629699707,6.459437370300293
meetingroom1_8,21,2,15,6,-5.505441188812256,11.505441665649414
meetingroom1_8,21,3,9,12,5.246835231781006,6.753164768218994
meetingroom1_8,21,4,14,7,-2.1479203701019287,9.147920608520508
meetingroom1_8,21,5,12,9,10.408222198486328,1.4082221984863281
meetingroom1_9,23,1,0,23,48.111785888671875,25.111785888671875
meetingroom1_9,23,2,48,-25,-8.307520866394043,16.69247817993164
meetingroom1_9,23,3,40,-17,-20.68604850769043,3.6860485076904297
meetingroom1_9,23,4,19,4,11.078935623168945,7.078935623168945
meetingroom1_9,23,5,30,-7,3.437683343887329,10.43768310546875
meetingroom1_9,23,6,33,-10,-5.742684364318848,4.257315635681152
meetingroom1_9,23,7,27,-4,4.122529983520508,8.122529983520508
meetingroom2_0,27,1,0,27,4.674955368041992,22.325044631958008
meetingroom2_0,27,2,5,22,7.089807510375977,14.910192489624023
meetingroom2_0,27,3,12,15,-0.018368015065789223,15.018367767333984
meetingroom2_0,27,4,12,15,-2.2873382568359375,17.287338256835938
meetingroom2_0,27,5,10,17,2.846574068069458,14.153426170349121
meetingroom2_0,27,6,13,14,-0.7817715406417847,14.781771659851074
meetingroom2_0,27,7,12,15,5.14756965637207,9.85243034362793
meetingroom2_1,23,1,0,23,11.578210830688477,11.421789169311523
meetingroom2_1,23,2,12,11,9.64157485961914,1.3584251403808594
meetingroom2_2,24,1,0,24,11.655667304992676,12.344332695007324
meetingroom2_2,24,2,12,12,4.053449630737305,7.946550369262695
meetingroom2_2,24,3,16,8,2.1775155067443848,5.822484493255615
meetingroom2_2,24,4,18,6,7.545803070068359,1.5458030700683594
meetingroom2_3,29,1,0,29,8.427933692932129,20.572067260742188
meetingroom2_3,29,2,8,21,5.579134941101074,15.420865058898926
meetingroom2_3,29,3,14,15,1.6882447004318237,13.311755180358887
meetingroom2_3,29,4,16,13,3.168208122253418,9.831791877746582
meetingroom2_3,29,5,19,10,4.3373589515686035,5.6626410484313965
meetingroom2_3,29,6,23,6,4.186084270477295,1.813915729522705
meetingroom2_4,22,1,0,22,0.3449438810348511,21.65505599975586
meetingroom2_4,22,2,0,22,2.433234214782715,19.56676483154297
meetingroom2_4,22,3,2,20,6.296397686004639,13.703601837158203
meetingroom2_4,22,4,8,14,-0.36806851625442505,14.36806869506836
meetingroom2_4,22,5,8,14,6.792487144470215,7.207512855529785
meetingroom2_4,22,6,15,7,-2.450407028198242,9.450407028198242
meetingroom2_4,22,7,13,9,3.149191379547119,5.850808620452881
meetingroom2_5,24,1,0,24,6.304886817932129,17.695114135742188
meetingroom2_5,24,2,6,18,4.7612528800964355,13.238746643066406
meetingroom2_5,24,3,11,13,1.6465046405792236,11.353495597839355
meetingroom2_5,24,4,13,11,5.322525978088379,5.677474021911621
meetingroom2_5,24,5,18,6,4.55312442779541,1.4468755722045898
meetingroom2_6,26,1,0,26,21.441110610961914,4.558889389038086
meetingroom2_6,26,2,21,5,7.6908979415893555,2.6908979415893555
meetingroom2_7,28,1,0,28,26.312864303588867,1.6871356964111328
meetingroom2_8,28,1,0,28,39.46491622924805,11.464916229248047
meetingroom2_8,28,2,39,-11,-2.53029727935791,8.46970272064209
meetingroom2_8,28,3,36,-8,-4.617294788360596,3.3827052116394043
meetingroom2_8,28,4,31,-3,-2.017317771911621,0.9826822280883789
meetingroom2_9,31,1,1,30,27.529268264770508,2.470731735229492
officecrawl1_0,26,1,0,26,0.5637161731719971,25.436283111572266
officecrawl1_0,26,2,1,25,19.396638870239258,5.603361129760742
officecrawl1_0,26,3,20,6,12.697670936584473,6.697670936584473
officecrawl1_0,26,4,33,-7,1.9406830072402954,8.940683364868164
officecrawl1_0,26,5,35,-9,-9.030312538146973,0.030312538146972656
officecrawl1_1,36,1,6,30,10.808272361755371,19.191726684570312
officecrawl1_1,36,2,17,19,5.717868328094482,13.28213119506836
officecrawl1_1,36,3,23,13,5.95484733581543,7.04515266418457
officecrawl1_1,36,4,29,7,-0.18419072031974792,7.18419075012207
officecrawl1_1,36,5,29,7,6.452691078186035,0.5473089218139648
officecrawl1_2,26,1,0,26,3.5682146549224854,22.431785583496094
officecrawl1_2,26,2,4,22,9.384193420410156,12.615806579589844
officecrawl1_2,26,3,13,13,5.017598628997803,7.982401371002197
officecrawl1_2,26,4,18,8,1.398344874382019,6.601655006408691
officecrawl1_2,26,5,19,7,-0.2988092303276062,7.298809051513672
officecrawl1_2,26,6,19,7,6.9988112449646,0.0011887550354003906
officecrawl1_3,21,1,0,21,-10.41408634185791,31.414085388183594
officecrawl1_3,21,2,0,21,-4.626572132110596,25.626571655273438
officecrawl1_3,21,3,0,21,-2.331845998764038,23.331846237182617
officecrawl1_3,21,4,0,21,2.769730567932129,18.230270385742188
officecrawl1_3,21,5,3,18,12.854815483093262,5.145184516906738
officecrawl1_3,21,6,16,5,-0.4787566661834717,5.478756904602051
officecrawl1_3,21,7,16,5,-3.5054783821105957,8.505477905273438
officecrawl1_4,31,1,1,30,36.941627502441406,6.941627502441406
officecrawl1_4,31,2,38,-7,-5.1310343742370605,1.8689656257629395
officecrawl1_5,23,1,0,23,-4.065000057220459,27.065000534057617
officecrawl1_5,23,2,0,23,-5.030752658843994,28.030752182006836
officecrawl1_5,23,3,0,23,-0.28155601024627686,23.28155517578125
officecrawl1_5,23,4,0,23,-2.1481454372406006,25.14814567565918
officecrawl1_5,23,5,0,23,-1.8237439393997192,24.82374382019043
officecrawl1_5,23,6,0,23,4.155043601989746,18.844955444335938
officecrawl1_5,23,7,4,19,-2.1360466480255127,21.13604736328125
officecrawl1_6,27,1,0,27,19.21670913696289,7.783290863037109
officecrawl1_6,27,2,19,8,22.338579177856445,14.338579177856445
officecrawl1_6,27,3,41,-14,9.72512435913086,23.72512435913086
officecrawl1_6,27,4,48,-21,19.180805206298828,40.18080520629883
officecrawl1_6,27,5,48,-21,11.803689002990723,32.803688049316406
officecrawl1_6,27,6,48,-21,3.0250182151794434,24.0250186920166
officecrawl1_6,27,7,48,-21,13.51119613647461,34.51119613647461
officecrawl1_7,20,1,0,20,21.870027542114258,1.8700275421142578
officecrawl1_8,32,1,2,30,17.49000358581543,12.50999641418457
officecrawl1_8,32,2,19,13,16.01422691345215,3.0142269134521484
officecrawl1_8,32,3,35,-3,0.9164127111434937,3.916412830352783
officecrawl1_8,32,4,36,-4,1.3547356128692627,5.354735374450684
officecrawl1_8,32,5,37,-5,-2.8953447341918945,2.1046552658081055
officecrawl1_9,33,1,3,30,34.191627502441406,4.191627502441406
officecrawl1_9,33,2,37,-4,-1.4097397327423096,2.5902602672576904
officecrawl2_0,31,1,1,30,-1.3709716796875,31.3709716796875
officecrawl2_0,31,2,0,31,3.7977917194366455,27.202207565307617
officecrawl2_0,31,3,4,27,-0.21390071511268616,27.21390151977539
officecrawl2_0,31,4,4,27,5.775778770446777,21.224220275878906
officecrawl2_0,31,5,10,21,3.4503116607666016,17.5496883392334
officecrawl2_0,31,6,13,18,1.6593728065490723,16.340627670288086
officecrawl2_0,31,7,15,16,4.324596405029297,11.675403594970703
officecrawl2_1,24,1,0,24,15.472590446472168,8.527409553527832
officecrawl2_1,24,2,15,9,6.593805313110352,2.4061946868896484
officecrawl2_2,48,1,18,30,8.541406631469727,21.458593368530273
officecrawl2_2,48,2,27,21,5.9792304039001465,15.020769119262695
officecrawl2_2,48,3,33,15,4.0007452964782715,10.99925422668457
officecrawl2_2,48,4,37,11,2.2783820629119873,8.721617698669434
officecrawl2_2,48,5,39,9,3.0702028274536133,5.929797172546387
officecrawl2_2,48,6,42,6,0.6851454377174377,5.314854621887207
officecrawl2_2,48,7,43,5,0.3403920531272888,4.659607887268066
officecrawl2_3,42,1,12,30,31.05854606628418,1.0585460662841797
officecrawl2_4,24,1,0,24,6.19537353515625,17.80462646484375
officecrawl2_4,24,2,6,18,5.945981979370117,12.054018020629883
officecrawl2_4,24,3,12,12,5.3667378425598145,6.6332621574401855
officecrawl2_4,24,4,17,7,0.527530312538147,6.472469806671143
officecrawl2_4,24,5,18,6,-2.341860055923462,8.341859817504883
officecrawl2_4,24,6,16,8,-0.20498959720134735,8.204989433288574
officecrawl2_4,24,7,16,8,5.064993381500244,2.935006618499756
officecrawl2_6,28,1,0,28,6.344141006469727,21.655858993530273
officecrawl2_6,28,2,6,22,5.0529375076293945,16.947063446044922
officecrawl2_6,28,3,11,17,6.428621292114258,10.571378707885742
officecrawl2_6,28,4,17,11,5.530187606811523,5.469812393188477
officecrawl2_6,28,5,23,5,4.224715709686279,0.7752842903137207
officecrawl2_7,33,1,3,30,25.874719619750977,4.125280380249023
officecrawl2_7,33,2,29,4,4.382359027862549,0.38235902786254883
officecrawl2_8,22,1,0,22,24.51000213623047,2.5100021362304688
officecrawl2_9,27,1,0,27,7.270593643188477,19.729406356811523
officecrawl2_9,27,2,7,20,7.783483028411865,12.216516494750977
officecrawl2_9,27,3,15,12,5.218492031097412,6.781507968902588
officecrawl2_9,27,4,20,7,7.0152506828308105,0.015250682830810547
officecrawl3_1,26,1,0,26,27.175521850585938,1.1755218505859375
officecrawl3_2,24,1,0,24,18.79230499267578,5.207695007324219
officecrawl3_2,24,2,19,5,-6.482076168060303,11.482076644897461
officecrawl3_2,24,3,13,11,6.7255940437316895,4.2744059562683105
officecrawl3_2,24,4,20,4,-0.614300549030304,4.614300727844238
officecrawl3_2,24,5,19,5,1.3175795078277588,3.682420492172241
officecrawl3_2,24,6,20,4,5.768560409545898,1.7685604095458984
officecrawl3_3,32,1,2,30,14.512983322143555,15.487016677856445
officecrawl3_3,32,2,17,15,6.745272159576416,8.254728317260742
officecrawl3_3,32,3,24,8,4.211891174316406,3.7881088256835938
officecrawl3_3,32,4,28,4,3.1725640296936035,0.8274359703063965
officecrawl3_4,20,1,0,20,26.78635597229004,6.786355972290039
officecrawl3_4,20,2,27,-7,-7.436022758483887,0.4360227584838867
officecrawl3_5,27,1,0,27,-2.661778211593628,29.66177749633789
officecrawl3_5,27,2,0,27,-1.0512046813964844,28.051204681396484
officecrawl3_5,27,3,0,27,1.7943832874298096,25.205615997314453
officecrawl3_5,27,4,2,25,6.735413551330566,18.26458740234375
officecrawl3_5,27,5,9,18,-1.594709873199463,19.594709396362305
officecrawl3_5,27,6,7,20,5.553653717041016,14.446346282958984
officecrawl3_5,27,7,13,14,5.092095851898193,8.907903671264648
officecrawl3_6,26,1,0,26,43.85048294067383,17.850482940673828
officecrawl3_6,26,2,44,-18,-7.617523193359375,10.382476806640625
officecrawl3_6,26,3,36,-10,-7.143679618835449,2.856320381164551
officecrawl3_7,28,1,0,28,7.717752456665039,20.28224754333496
officecrawl3_7,28,2,8,20,5.70188570022583,14.298114776611328
officecrawl3_7,28,3,14,14,6.137195587158203,7.862804412841797
officecrawl3_7,28,4,20,8,1.0018072128295898,6.99819278717041
officecrawl3_7,28,5,21,7,1.0239073038101196,5.97609281539917
officecrawl3_7,28,6,22,6,3.7698163986206055,2.2301836013793945
officecrawl3_8,19,1,0,19,14.623780250549316,4.376219749450684
officecrawl3_8,19,2,15,4,0.9809163808822632,3.0190834999084473
officecrawl3_8,19,3,16,3,3.281158208847046,0.2811582088470459
officecrawl3_9,25,1,0,25,6.416513442993164,18.583486557006836
officecrawl3_9,25,2,6,19,5.214972972869873,13.785026550292969
officecrawl3_9,25,3,11,14,9.531519889831543,4.468480110168457
officecrawl3_9,25,4,21,4,-10.348615646362305,14.348615646362305
officecrawl3_9,25,5,11,14,11.758805274963379,2.241194725036621
officeroom1_0,27,1,0,27,15.271995544433594,11.728004455566406
officeroom1_0,27,2,15,12,3.1456708908081055,8.854329109191895
officeroom1_0,27,3,18,9,-1.229014277458191,10.22901439666748
officeroom1_0,27,4,17,10,8.074898719787598,1.9251012802124023
officeroom1_1,28,1,0,28,16.173879623413086,11.826120376586914
officeroom1_1,28,2,16,12,9.048172950744629,2.951827049255371
officeroom1_2,29,1,0,29,12.382026672363281,16.61797332763672
officeroom1_2,29,2,12,17,16.05962371826172,0.9403762817382812
officeroom1_3,29,1,0,29,36.32052230834961,7.320522308349609
officeroom1_3,29,2,36,-7,-4.514214038848877,2.485785961151123
officeroom1_4,21,1,0,21,12.47973918914795,8.52026081085205
officeroom1_4,21,2,12,9,4.400770664215088,4.599229335784912
officeroom1_4,21,3,16,5,11.154650688171387,6.154650688171387
officeroom1_4,21,4,27,-6,6.886152744293213,12.886152267456055
officeroom1_4,21,5,34,-13,-12.568918228149414,0.43108177185058594
officeroom1_5,22,1,0,22,7.001534938812256,14.998464584350586
officeroom1_5,22,2,7,15,6.3313889503479,8.668611526489258
officeroom1_5,22,3,13,9,3.799757242202759,5.20024299621582
officeroom1_5,22,4,17,5,0.6132073998451233,4.3867926597595215
officeroom1_5,22,5,18,4,3.6809585094451904,0.31904149055480957
officeroom1_6,22,1,0,22,10.14114761352539,11.85885238647461
officeroom1_6,22,2,10,12,3.3372387886047363,8.662761688232422
officeroom1_6,22,3,13,9,0.26057103276252747,8.739428520202637
officeroom1_6,22,4,13,9,2.5533618927001953,6.446638107299805
officeroom1_6,22,5,16,6,0.4412277936935425,5.558772087097168
officeroom1_6,22,6,16,6,0.035995349287986755,5.9640045166015625
officeroom1_6,22,7,16,6,-2.7184669971466064,8.718466758728027
officeroom1_7,22,1,0,22,-1.7239760160446167,23.723976135253906
officeroom1_7,22,2,0,22,-2.8665733337402344,24.866573333740234
officeroom1_7,22,3,0,22,-3.1560451984405518,25.15604591369629
officeroom1_7,22,4,0,22,9.774520874023438,12.225479125976562
officeroom1_7,22,5,10,12,-0.15731562674045563,12.157315254211426
officeroom1_7,22,6,10,12,-6.467928409576416,18.467927932739258
officeroom1_7,22,7,4,18,23.112852096557617,5.112852096557617
officeroom1_8,22,1,0,22,15.17305850982666,6.82694149017334
officeroom1_8,22,2,15,7,5.149505138397217,1.8504948616027832
officeroom1_9,27,1,0,27,21.60407066345215,5.395929336547852
officeroom1_9,27,2,22,5,13.277688026428223,8.277688026428223
officeroom1_9,27,3,35,-8,0.1592922955751419,8.159292221069336
officeroom1_9,27,4,35,-8,11.632161140441895,19.632160186767578
officeroom1_9,27,5,47,-20,-14.3062744140625,5.6937255859375
officeroom1_9,27,6,33,-6,-7.517444133758545,1.517444133758545
officetrashshadows_1,34,1,4,30,8.212442398071289,21.78755760192871
officetrashshadows_1,34,2,12,22,3.7044928073883057,18.295507431030273
officetrashshadows_1,34,3,16,18,-0.46110764145851135,18.46110725402832
officetrashshadows_1,34,4,16,18,2.5086567401885986,15.49134349822998
officetrashshadows_1,34,5,19,15,-0.5159565806388855,15.51595687866211
officetrashshadows_1,34,6,18,16,3.009622097015381,12.990377426147461
officetrashshadows_1,34,7,21,13,0.9623826742172241,12.037617683410645
officetrashshadows_2,23,1,0,23,4.865285873413086,18.134714126586914
officetrashshadows_2,23,2,5,18,6.185629844665527,11.814370155334473
officetrashshadows_2,23,3,11,12,2.6631550788879395,9.336845397949219
officetrashshadows_2,23,4,14,9,0.05363796278834343,8.946362495422363
officetrashshadows_2,23,5,14,9,1.5020062923431396,7.497993469238281
officetrashshadows_2,23,6,16,7,2.478682041168213,4.521317958831787
officetrashshadows_2,23,7,18,5,4.414641857147217,0.5853581428527832
officetrashshadows_3,27,1,0,27,19.133338928222656,7.866661071777344
officetrashshadows_3,27,2,19,8,4.039783954620361,3.9602160453796387
officetrashshadows_3,27,3,23,4,4.796821594238281,0.7968215942382812
officetrashshadows_4,36,1,6,30,28.076171875,1.923828125
officetrashshadows_5,39,1,9,30,5.861003398895264,24.138996124267578
officetrashshadows_5,39,2,15,24,3.566864490509033,20.433135986328125
officetrashshadows_5,39,3,19,20,6.804753303527832,13.195246696472168
officetrashshadows_5,39,4,26,13,-3.17189884185791,16.171897888183594
officetrashshadows_5,39,5,23,16,1.6073720455169678,14.392627716064453
officetrashshadows_5,39,6,25,14,1.582379937171936,12.417619705200195
officetrashshadows_5,39,7,27,12,-2.876889944076538,14.876890182495117
officetrashshadows_6,37,1,7,30,7.1386823654174805,22.861316680908203
officetrashshadows_6,37,2,14,23,11.238570213317871,11.761429786682129
officetrashshadows_6,37,3,25,12,5.9677557945251465,6.0322442054748535
officetrashshadows_6,37,4,31,6,1.1404311656951904,4.8595685958862305
officetrashshadows_6,37,5,32,5,1.4597240686416626,3.540276050567627
officetrashshadows_6,37,6,33,4,1.4502216577529907,2.549778461456299
officetrashshadows_8,25,1,0,25,10.162857055664062,14.837142944335938
officetrashshadows_8,25,2,10,15,7.833000183105469,7.166999816894531
officetrashshadows_8,25,3,18,7,-0.3248674273490906,7.324867248535156
officetrashshadows_8,25,4,18,7,-2.3483641147613525,9.348363876342773
officetrashshadows_8,25,5,16,9,5.323803901672363,3.6761960983276367
officetrashshadows_8,25,6,21,4,-2.3998541831970215,6.3998541831970215
officetrashshadows_8,25,7,19,6,3.2168710231781006,2.7831289768218994
officetrashshadows_9,27,1,0,27,31.907470703125,4.907470703125
officetrashshadows_9,27,2,32,-5,-9.345714569091797,4.345714569091797
officetrashshadows_9,27,3,23,4,8.811209678649902,4.811209678649902
officetrashshadows_9,27,4,32,-5,-5.823111534118652,0.8231115341186523
officetrash_0,26,1,0,26,36.951995849609375,10.951995849609375
officetrash_0,26,2,37,-11,-7.954586029052734,3.0454139709472656
officetrash_0,26,3,29,-3,-3.4338042736053467,0.4338042736053467
officetrash_1,23,1,0,23,9.940003395080566,13.059996604919434
officetrash_1,23,2,10,13,9.365883827209473,3.6341161727905273
officetrash_1,23,3,19,4,5.910801887512207,1.910801887512207
officetrash_2,25,1,0,25,5.7890400886535645,19.210960388183594
officetrash_2,25,2,6,19,11.053967475891113,7.946032524108887
officetrash_2,25,3,17,8,6.215738773345947,1.7842612266540527
officetrash_4,33,1,3,30,27.8531436920166,2.1468563079833984
officetrash_5,32,1,2,30,25.123817443847656,4.876182556152344
officetrash_5,32,2,27,5,-2.114863395690918,7.114863395690918
officetrash_5,32,3,25,7,5.777626991271973,1.2223730087280273
officetrash_6,24,1,0,24,11.027183532714844,12.972816467285156
officetrash_6,24,2,11,13,9.04830551147461,3.9516944885253906
officetrash_6,24,3,20,4,4.389778137207031,0.38977813720703125
officetrash_7,31,1,1,30,19.355003356933594,10.644996643066406
officetrash_7,31,2,20,11,10.178394317626953,0.8216056823730469
officetrash_8,25,1,0,25,17.880008697509766,7.119991302490234
officetrash_8,25,2,18,7,6.807785987854004,0.1922140121459961
outdoorsbalcony1_0,24,1,0,24,39.99070739746094,15.990707397460938
outdoorsbalcony1_0,24,2,40,-16,-21.447383880615234,5.447383880615234
outdoorsbalcony1_0,24,3,19,5,3.1150548458099365,1.8849451541900635
outdoorsbalcony1_1,23,1,0,23,34.26561737060547,11.265617370605469
outdoorsbalcony1_1,23,2,34,-11,6.595272064208984,17.595272064208984
outdoorsbalcony1_1,23,3,41,-18,4.425362586975098,22.42536163330078
outdoorsbalcony1_1,23,4,45,-22,-13.445669174194336,8.554330825805664
outdoorsbalcony1_1,23,5,32,-9,6.825861930847168,15.825861930847168
outdoorsbalcony1_1,23,6,39,-16,7.145263671875,23.145263671875
outdoorsbalcony1_1,23,7,46,-23,-6.907433986663818,16.092565536499023
outdoorsbalcony1_2,33,1,3,30,41.89131546020508,11.891315460205078
outdoorsbalcony1_2,33,2,45,-12,8.073603630065918,20.073604583740234
outdoorsbalcony1_2,33,3,48,-15,-3.437143325805664,11.562856674194336
outdoorsbalcony1_2,33,4,45,-12,-7.163052558898926,4.836947441101074
outdoorsbalcony1_2,33,5,38,-5,7.125329971313477,12.125329971313477
outdoorsbalcony1_2,33,6,45,-12,4.1943769454956055,16.194377899169922
outdoorsbalcony1_2,33,7,48,-15,-9.939009666442871,5.060990333557129
outdoorsbalcony1_3,44,1,14,30,33.43220138549805,3.432201385498047
outdoorsbalcony1_3,44,2,47,-3,-11.219022750854492,8.219022750854492
outdoorsbalcony1_3,44,3,36,8,8.125123977661133,0.1251239776611328
outdoorsbalcony1_4,29,1,0,29,22.63164520263672,6.368354797363281
outdoorsbalcony1_4,29,2,23,6,2.2213046550750732,3.7786953449249268
outdoorsbalcony1_4,29,3,25,4,2.649472236633301,1.3505277633666992
outdoorsbalcony1_6,29,1,0,29,23.14568328857422,5.854316711425781
outdoorsbalcony1_6,29,2,23,6,6.317288398742676,0.3172883987426758
outdoorsbalcony1_9,38,1,8,30,12.913863182067871,17.086135864257812
outdoorsbalcony1_9,38,2,21,17,11.496743202209473,5.503256797790527
outdoorsbalcony1_9,38,3,32,6,0.6714065074920654,5.3285932540893555
outdoorsbalcony1_9,38,4,33,5,9.49290943145752,4.4929094314575195
outdoorsbalcony1_9,38,5,42,-4,-0.14247466623783112,3.85752534866333
outdoorsbalcony1_9,38,6,42,-4,-1.4027091264724731,2.5972909927368164
outdoorsbalcony2_0,23,1,0,23,12.661368370056152,10.338631629943848
outdoorsbalcony2_0,23,2,13,10,-1.3092217445373535,11.309221267700195
outdoorsbalcony2_0,23,3,12,11,14.046195030212402,3.0461950302124023
outdoorsbalcony2_0,23,4,26,-3,-2.3224594593048096,0.6775405406951904
outdoorsbalcony2_1,27,1,0,27,19.652318954467773,7.347681045532227
outdoorsbalcony2_1,27,2,20,7,6.202237606048584,0.797762393951416
outdoorsbalcony2_2,34,1,4,30,0.33806759119033813,29.66193199157715
outdoorsbalcony2_2,34,2,4,30,11.006071090698242,18.993928909301758
outdoorsbalcony2_2,34,3,15,19,12.731639862060547,6.268360137939453
outdoorsbalcony2_2,34,4,28,6,5.809628009796143,0.19037199020385742
outdoorsbalcony2_4,21,1,0,21,15.641325950622559,5.358674049377441
outdoorsbalcony2_4,21,2,16,5,-0.38330891728401184,5.3833088874816895
outdoorsbalcony2_4,21,3,16,5,0.6454979777336121,4.354502201080322
outdoorsbalcony2_4,21,4,17,4,0.2697252333164215,3.7302746772766113
outdoorsbalcony2_4,21,5,17,4,-1.41416597366333,5.41416597366333
outdoorsbalcony2_4,21,6,16,5,-0.8429458141326904,5.8429460525512695
outdoorsbalcony2_4,21,7,15,6,-0.5329716205596924,6.532971382141113
outdoorsbalcony2_5,23,1,0,23,23.488962173461914,0.48896217346191406
outdoorsbalcony2_6,26,1,0,26,18.767202377319336,7.232797622680664
outdoorsbalcony2_6,26,2,19,7,3.9780032634735107,3.0219967365264893
outdoorsbalcony2_6,26,3,23,3,1.370464563369751,1.629535436630249
outdoorsbalcony2_7,27,1,0,27,28.17624282836914,1.1762428283691406
outdoorsbalcony2_8,24,1,0,24,22.169597625732422,1.8304023742675781
outdoorsbalcony2_9,21,1,0,21,13.103958129882812,7.8960418701171875
outdoorsbalcony2_9,21,2,13,8,5.6871337890625,2.3128662109375
outdoorsfossils_3,24,1,0,24,14.0329008102417,9.9670991897583
outdoorsfossils_3,24,2,14,10,3.040097236633301,6.959902763366699
outdoorsfossils_3,24,3,17,7,1.7116450071334839,5.288354873657227
outdoorsfossils_3,24,4,19,5,2.8282687664031982,2.1717312335968018
outdoorsfossils_5,25,1,0,25,9.273310661315918,15.726689338684082
outdoorsfossils_5,25,2,9,16,7.293280601501465,8.706719398498535
outdoorsfossils_5,25,3,16,9,-3.689985752105713,12.689985275268555
outdoorsfossils_5,25,4,12,13,3.7061164379119873,9.293883323669434
outdoorsfossils_5,25,5,16,9,-6.133160591125488,15.133160591125488
outdoorsfossils_5,25,6,10,15,5.554621696472168,9.445378303527832
outdoorsfossils_5,25,7,16,9,-2.017603635787964,11.017603874206543
outdoorsfossils_6,24,1,0,24,20.241622924804688,3.7583770751953125
outdoorsfossils_6,24,2,20,4,3.3358054161071777,0.6641945838928223
outdoorsfossils_7,23,1,0,23,10.348190307617188,12.651809692382812
outdoorsfossils_7,23,2,10,13,11.13925552368164,1.8607444763183594
outdoorsfossils_8,24,1,0,24,13.190587043762207,10.809412956237793
outdoorsfossils_8,24,2,13,11,5.142692565917969,5.857307434082031
outdoorsfossils_8,24,3,18,6,3.808746337890625,2.191253662109375
outdoorsfossils_9,25,1,0,25,32.168800354003906,7.168800354003906
outdoorsfossils_9,25,2,32,-7,-9.948341369628906,2.9483413696289062
outdoorsplants_0,37,1,7,30,16.32717514038086,13.67282485961914
outdoorsplants_0,37,2,23,14,19.52752685546875,5.52752685546875
outdoorsplants_0,37,3,43,-6,2.6388392448425293,8.638839721679688
outdoorsplants_0,37,4,46,-9,19.727800369262695,28.727800369262695
outdoorsplants_0,37,5,48,-11,13.621190071105957,24.62118911743164
outdoorsplants_0,37,6,48,-11,-7.974146842956543,3.025853157043457
outdoorsplants_0,37,7,40,-3,-8.965276718139648,5.965276718139648
outdoorsplants_1,34,1,4,30,22.736663818359375,7.263336181640625
outdoorsplants_1,34,2,27,7,13.398812294006348,6.398812294006348
outdoorsplants_1,34,3,40,-6,18.35896110534668,24.35896110534668
outdoorsplants_1,34,4,48,-14,11.557512283325195,25.557512283325195
outdoorsplants_1,34,5,48,-14,11.681551933288574,25.68155288696289
outdoorsplants_1,34,6,48,-14,10.859711647033691,24.859710693359375
outdoorsplants_1,34,7,48,-14,13.761269569396973,27.761268615722656
outdoorsplants_2,32,1,2,30,1.2375677824020386,28.762432098388672
outdoorsplants_2,32,2,3,29,14.353018760681152,14.646981239318848
outdoorsplants_2,32,3,17,15,20.459413528442383,5.459413528442383
outdoorsplants_2,32,4,37,-5,13.418618202209473,18.418617248535156
outdoorsplants_2,32,5,48,-16,18.13660430908203,34.13660430908203
outdoorsplants_2,32,6,48,-16,11.127703666687012,27.127704620361328
outdoorsplants_2,32,7,48,-16,14.32520580291748,30.325206756591797
outdoorsplants_3,23,1,0,23,20.442625045776367,2.557374954223633
outdoorsplants_6,25,1,0,25,23.7089900970459,1.2910099029541016
outdoorsplants_7,19,1,0,19,18.006179809570312,0.9938201904296875
outdoorsplants_8,20,1,0,20,14.376489639282227,5.623510360717773
outdoorsplants_8,20,2,14,6,1.3775254487991333,4.622474670410156
outdoorsplants_8,20,3,15,5,2.8806028366088867,2.1193971633911133
outdoorsplants_9,23,1,0,23,23.782581329345703,0.7825813293457031
photobox1_0,22,1,0,22,13.907309532165527,8.092690467834473
photobox1_0,22,2,14,8,-3.175078868865967,11.175079345703125
photobox1_0,22,3,11,11,0.5510522723197937,10.44894790649414
photobox1_0,22,4,12,10,0.2220926284790039,9.777907371520996
photobox1_0,22,5,12,10,2.159163236618042,7.840836524963379
photobox1_0,22,6,14,8,0.1946326196193695,7.805367469787598
photobox1_0,22,7,14,8,-2.9180240631103516,10.918024063110352
photobox1_1,22,1,0,22,18.52800750732422,3.4719924926757812
photobox1_1,22,2,19,3,2.441455125808716,0.5585448741912842
photobox1_2,22,1,0,22,26.090585708618164,4.090585708618164
photobox1_2,22,2,26,-4,-6.3355937004089355,2.3355937004089355
photobox1_3,23,1,0,23,23.31450653076172,0.31450653076171875
photobox1_4,21,1,0,21,14.419962882995605,6.5800371170043945
photobox1_4,21,2,14,7,6.8575944900512695,0.14240550994873047
photobox1_5,22,1,0,22,23.75572395324707,1.7557239532470703
photobox1_6,23,1,0,23,-1.0617483854293823,24.061748504638672
photobox1_6,23,2,0,23,4.635994911193848,18.36400604248047
photobox1_6,23,3,5,18,7.4168267250061035,10.583173751831055
photobox1_6,23,4,12,11,6.501107215881348,4.498892784118652
photobox1_6,23,5,19,4,9.594366073608398,5.594366073608398
photobox1_6,23,6,29,-6,10.576823234558105,16.576824188232422
photobox1_6,23,7,40,-17,-7.312928676605225,9.687070846557617
photobox1_7,22,1,0,22,31.28148651123047,9.281486511230469
photobox1_7,22,2,31,-9,-7.07904052734375,1.92095947265625
photobox1_8,22,1,0,22,14.604382514953613,7.395617485046387
photobox1_8,22,2,15,7,6.988696098327637,0.011303901672363281
photobox1_9,26,1,0,26,23.225889205932617,2.774110794067383
photobox2_0,23,1,0,23,18.77489471435547,4.225105285644531
photobox2_0,23,2,19,4,4.961901664733887,0.9619016647338867
photobox2_1,23,1,0,23,15.591479301452637,7.408520698547363
photobox2_1,23,2,16,7,1.4231868982315063,5.576813220977783
photobox2_1,23,3,17,6,5.013394832611084,0.986605167388916
photobox2_2,23,1,0,23,15.798685073852539,7.201314926147461
photobox2_2,23,2,16,7,5.855564117431641,1.1444358825683594
photobox2_3,23,1,0,23,21.096342086791992,1.9036579132080078
photobox2_4,24,1,0,24,11.580520629882812,12.419479370117188
photobox2_4,24,2,12,12,11.672896385192871,0.3271036148071289
photobox2_5,26,1,0,26,7.723983287811279,18.276016235351562
photobox2_5,26,2,8,18,11.383002281188965,6.616997718811035
photobox2_5,26,3,19,7,2.235323429107666,4.764676570892334
photobox2_5,26,4,21,5,0.24547234177589417,4.754527568817139
photobox2_5,26,5,21,5,2.0162723064422607,2.9837276935577393
photobox2_6,22,1,0,22,8.63124942779541,13.36875057220459
photobox2_6,22,2,9,13,5.271615028381348,7.728384971618652
photobox2_6,22,3,14,8,0.39279043674468994,7.6072096824646
photobox2_6,22,4,14,8,2.3339779376983643,5.666022300720215
photobox2_6,22,5,16,6,-0.9863857626914978,6.986385822296143
photobox2_6,22,6,15,7,2.9985830783843994,4.00141716003418
photobox2_6,22,7,18,4,0.7638586759567261,3.2361412048339844
photobox2_7,22,1,0,22,16.466428756713867,5.533571243286133
photobox2_7,22,2,16,6,8.329156875610352,2.3291568756103516
photobox2_8,29,1,0,29,52.09495544433594,23.094955444335938
photobox2_8,29,2,48,-19,-9.421503067016602,9.578496932983398
photobox2_8,29,3,39,-10,-0.11728543788194656,9.88271427154541
photobox2_8,29,4,39,-10,-3.9461255073547363,6.053874492645264
photobox2_8,29,5,35,-6,-0.734321653842926,5.265678405761719
photobox2_8,29,6,34,-5,-0.2897469699382782,4.7102532386779785
photobox2_8,29,7,34,-5,0.24092930555343628,5.240929126739502
photobox2_9,23,1,0,23,31.65467071533203,8.654670715332031
photobox2_9,23,2,32,-9,-5.577167510986328,3.422832489013672
photobox2_9,23,3,26,-3,-4.434863567352295,1.434863567352295
randomsurplus_0,19,1,0,19,4.1543660163879395,14.845634460449219
randomsurplus_0,19,2,4,15,-2.1288843154907227,17.128883361816406
randomsurplus_0,19,3,2,17,0.759986162185669,16.240013122558594
randomsurplus_0,19,4,3,16,-9.272680282592773,25.272680282592773
randomsurplus_0,19,5,0,19,6.082640647888184,12.917359352111816
randomsurplus_0,19,6,6,13,-5.561444282531738,18.561443328857422
randomsurplus_0,19,7,0,19,-8.55636215209961,27.55636215209961
randomsurplus_1,41,1,11,30,22.865999221801758,7.134000778198242
randomsurplus_1,41,2,34,7,9.41884994506836,2.4188499450683594
randomsurplus_2,20,1,0,20,25.112558364868164,5.112558364868164
randomsurplus_2,20,2,25,-5,7.11400842666626,12.114007949829102
randomsurplus_2,20,3,32,-12,18.617050170898438,30.617050170898438
randomsurplus_2,20,4,48,-28,-8.269305229187012,19.730693817138672
randomsurplus_2,20,5,40,-20,8.338630676269531,28.33863067626953
randomsurplus_2,20,6,48,-28,4.343368053436279,32.34336853027344
randomsurplus_2,20,7,48,-28,-3.914912700653076,24.085086822509766
randomsurplus_3,29,1,0,29,16.798337936401367,12.201662063598633
randomsurplus_3,29,2,17,12,12.8162202835083,0.8162202835083008
randomsurplus_4,29,1,0,29,29.26934814453125,0.26934814453125
randomsurplus_5,21,1,0,21,15.413029670715332,5.586970329284668
randomsurplus_5,21,2,15,6,-8.354430198669434,14.354430198669434
randomsurplus_5,21,3,7,14,10.636110305786133,3.363889694213867
randomsurplus_5,21,4,18,3,2.878873825073242,0.12112617492675781
randomsurplus_6,22,1,0,22,5.512949466705322,16.487051010131836
randomsurplus_6,22,2,6,16,7.971189975738525,8.028810501098633
randomsurplus_6,22,3,14,8,6.956026077270508,1.0439739227294922
randomsurplus_7,22,1,0,22,20.30347442626953,1.6965255737304688
randomsurplus_8,28,1,0,28,-1.1382777690887451,29.138277053833008
randomsurplus_8,28,2,0,28,4.363794326782227,23.636205673217773
randomsurplus_8,28,3,4,24,17.27678680419922,6.723213195800781
randomsurplus_8,28,4,21,7,1.6279940605163574,5.372005939483643
randomsurplus_8,28,5,23,5,14.265118598937988,9.265118598937988
randomsurplus_8,28,6,37,-9,-4.548341274261475,4.451658725738525
randomsurplus_8,28,7,32,-4,-10.865189552307129,6.865189552307129
randomsurplus_9,28,1,0,28,-5.145503520965576,33.145503997802734
randomsurplus_9,28,2,0,28,17.233793258666992,10.766206741333008
randomsurplus_9,28,3,17,11,9.125557899475098,1.8744421005249023
secondfloorbalcony_0,32,1,2,30,22.183439254760742,7.816560745239258
secondfloorbalcony_0,32,2,24,8,6.065387725830078,1.9346122741699219
secondfloorbalcony_1,34,1,4,30,34.719970703125,4.719970703125
secondfloorbalcony_1,34,2,39,-5,-2.0503201484680176,2.9496798515319824
secondfloorbalcony_3,20,1,0,20,6.387332439422607,13.612667083740234
secondfloorbalcony_3,20,2,6,14,4.607048988342285,9.392951011657715
secondfloorbalcony_3,20,3,11,9,-1.1677367687225342,10.167737007141113
secondfloorbalcony_3,20,4,10,10,-0.18798930943012238,10.187989234924316
secondfloorbalcony_3,20,5,10,10,2.6135332584381104,7.386466979980469
secondfloorbalcony_3,20,6,13,7,-3.08027720451355,10.080277442932129
secondfloorbalcony_3,20,7,10,10,3.387209892272949,6.612790107727051
secondfloorbalcony_4,23,1,0,23,-10.310507774353027,33.310508728027344
secondfloorbalcony_4,23,2,0,23,-10.115982055664062,33.11598205566406
secondfloorbalcony_4,23,3,0,23,-8.03380012512207,31.03380012512207
secondfloorbalcony_4,23,4,0,23,26.79231071472168,3.7923107147216797
secondfloorbalcony_4,23,5,27,-4,16.40240478515625,20.40240478515625
secondfloorbalcony_4,23,6,43,-20,23.877607345581055,43.87760925292969
secondfloorbalcony_4,23,7,48,-25,15.98611068725586,40.98611068725586
secondfloorbalcony_6,23,1,0,23,24.19118309020996,1.191183090209961
secondfloorbalcony_7,19,1,0,19,9.82826042175293,9.17173957824707
secondfloorbalcony_7,19,2,10,9,4.970318794250488,4.029681205749512
secondfloorbalcony_7,19,3,15,4,2.0466766357421875,1.9533233642578125
secondfloorbalcony_8,19,1,0,19,13.718512535095215,5.281487464904785
secondfloorbalcony_8,19,2,14,5,-1.8172472715377808,6.81724739074707
secondfloorbalcony_8,19,3,12,7,-1.5304588079452515,8.530458450317383
secondfloorbalcony_8,19,4,10,9,4.1544270515441895,4.8455729484558105
secondfloorbalcony_8,19,5,14,5,1.5467252731323242,3.453274726867676
secondfloorbalcony_8,19,6,16,3,-4.919793128967285,7.919793128967285
secondfloorbalcony_8,19,7,11,8,4.086079120635986,3.9139208793640137
secondfloorbalcony_9,21,1,0,21,11.301034927368164,9.698965072631836
secondfloorbalcony_9,21,2,11,10,3.183171272277832,6.816828727722168
secondfloorbalcony_9,21,3,14,7,-0.25319740176200867,7.253197193145752
secondfloorbalcony_9,21,4,14,7,5.681420803070068,1.3185791969299316
tableroom_0,19,1,0,19,5.117658615112305,13.882341384887695
tableroom_0,19,2,5,14,6.898702621459961,7.101297378540039
tableroom_0,19,3,12,7,5.882817268371582,1.117182731628418
tableroom_1,22,1,0,22,14.937145233154297,7.062854766845703
tableroom_1,22,2,15,7,6.563691139221191,0.4363088607788086
