filename,CorrectPosition,focus_time,index,label,pred,loss
home1_0,29,1,0,29,57.68112564086914,28.68112564086914
home1_0,29,2,48,-19,-14.337504386901855,4.6624956130981445
home1_0,29,3,34,-5,4.364197731018066,9.364197731018066
home1_0,29,4,38,-9,7.167165756225586,16.167165756225586
home1_0,29,5,45,-16,-10.376527786254883,5.623472213745117
home1_0,29,6,35,-6,-2.2128255367279053,3.7871744632720947
home1_0,29,7,33,-4,14.702359199523926,18.70235824584961
home1_1,23,1,0,23,11.819741249084473,11.180258750915527
home1_1,23,2,12,11,8.012097358703613,2.9879026412963867
home1_2,37,1,7,30,16.934368133544922,13.065631866455078
home1_2,37,2,24,13,10.455952644348145,2.5440473556518555
home1_3,32,1,2,30,17.733312606811523,12.266687393188477
home1_3,32,2,20,12,13.959057807922363,1.9590578079223633
home1_4,47,1,17,30,13.443167686462402,16.55683135986328
home1_4,47,2,30,17,7.299185752868652,9.700814247131348
home1_4,47,3,37,10,4.503142833709717,5.496857166290283
home1_4,47,4,42,5,-6.077355861663818,11.077356338500977
home1_4,47,5,36,11,8.425477027893066,2.5745229721069336
home1_5,47,1,17,30,35.17498016357422,5.174980163574219
home1_5,47,2,48,-1,5.06196928024292,6.06196928024292
home1_5,47,3,48,-1,-2.2930753231048584,1.2930753231048584
home1_6,34,1,4,30,33.10381317138672,3.1038131713867188
home1_6,34,2,37,-3,-2.7048425674438477,0.29515743255615234
home1_8,29,1,0,29,13.933323860168457,15.066676139831543
home1_8,29,2,14,15,8.57144546508789,6.428554534912109
home1_8,29,3,23,6,3.962151050567627,2.037848949432373
home1_9,26,1,0,26,3.426804304122925,22.573196411132812
home1_9,26,2,3,23,-0.13877782225608826,23.138778686523438
home1_9,26,3,3,23,-1.9264562129974365,24.926456451416016
home1_9,26,4,1,25,7.0504865646362305,17.949512481689453
home1_9,26,5,8,18,5.420072555541992,12.579927444458008
home1_9,26,6,13,13,5.663882255554199,7.336117744445801
home1_9,26,7,19,7,5.737083911895752,1.262916088104248
home2_0,38,1,8,30,31.560712814331055,1.5607128143310547
home2_2,43,1,13,30,-1.6771434545516968,31.677143096923828
home2_2,43,2,11,32,2.9466464519500732,29.053354263305664
home2_2,43,3,14,29,0.6118836402893066,28.38811683654785
home2_2,43,4,15,28,5.140524387359619,22.85947608947754
home2_2,43,5,20,23,2.0789458751678467,20.92105484008789
home2_2,43,6,22,21,1.6300221681594849,19.369977951049805
home2_2,43,7,24,19,1.6292811632156372,17.370718002319336
home2_3,31,1,1,30,7.556439399719238,22.443561553955078
home2_3,31,2,9,22,8.905866622924805,13.094133377075195
home2_3,31,3,18,13,7.420624732971191,5.579375267028809
home2_3,31,4,25,6,1.3768807649612427,4.623119354248047
home2_3,31,5,26,5,1.0059354305267334,3.9940645694732666
home2_3,31,6,27,4,1.4278019666671753,2.572197914123535
home2_4,34,1,4,30,1.2480570077896118,28.751943588256836
home2_4,34,2,5,29,3.2353062629699707,25.764694213867188
home2_4,34,3,8,26,5.808239936828613,20.191761016845703
home2_4,34,4,14,20,-1.135453224182129,21.135452270507812
home2_4,34,5,13,21,-2.791302442550659,23.791301727294922
home2_4,34,6,10,24,-1.2647807598114014,25.264780044555664
home2_4,34,7,9,25,0.5576832890510559,24.44231605529785
home2_5,30,1,0,30,8.92069149017334,21.079307556152344
home2_5,30,2,9,21,18.970243453979492,2.029756546020508
home2_6,29,1,0,29,12.620617866516113,16.379383087158203
home2_6,29,2,13,16,23.815807342529297,7.815807342529297
home2_6,29,3,37,-8,-0.7801746129989624,7.219825267791748
home2_6,29,4,36,-7,-1.000009298324585,5.999990463256836
home2_6,29,5,35,-6,0.2277975231409073,6.227797508239746
home2_6,29,6,35,-6,-1.147421956062317,4.852578163146973
home2_6,29,7,34,-5,2.16371488571167,7.16371488571167
home2_7,34,1,4,30,10.153825759887695,19.846174240112305
home2_7,34,2,14,20,8.48789119720459,11.51210880279541
home2_7,34,3,22,12,5.684369087219238,6.315630912780762
home2_7,34,4,28,6,3.0546462535858154,2.9453537464141846
home2_9,30,1,0,30,28.55342674255371,1.446573257446289
microkitchen1_0,21,1,0,21,15.618626594543457,5.381373405456543
microkitchen1_0,21,2,16,5,-2.0507850646972656,7.050785064697266
microkitchen1_0,21,3,14,7,-0.08758828043937683,7.087588310241699
microkitchen1_0,21,4,14,7,3.955955982208252,3.044044017791748
microkitchen1_0,21,5,18,3,-1.2738863229751587,4.273886203765869
microkitchen1_0,21,6,17,4,-2.441662311553955,6.441662311553955
microkitchen1_0,21,7,15,6,0.637356698513031,5.362643241882324
microkitchen1_1,21,1,0,21,23.650793075561523,2.6507930755615234
microkitchen1_2,21,1,0,21,36.15092086791992,15.150920867919922
microkitchen1_2,21,2,36,-15,-13.525799751281738,1.4742002487182617
microkitchen1_3,24,1,0,24,10.247455596923828,13.752544403076172
microkitchen1_3,24,2,10,14,11.107787132263184,2.8922128677368164
microkitchen1_4,25,1,0,25,26.1560115814209,1.1560115814208984
microkitchen1_5,25,1,0,25,32.21492004394531,7.2149200439453125
microkitchen1_5,25,2,32,-7,-4.091532230377197,2.9084677696228027
microkitchen1_6,25,1,0,25,8.87501049041748,16.124988555908203
microkitchen1_6,25,2,9,16,11.672250747680664,4.327749252319336
microkitchen1_6,25,3,21,4,2.25616455078125,1.74383544921875
microkitchen1_7,20,1,0,20,8.85604190826416,11.14395809173584
microkitchen1_7,20,2,9,11,2.6042301654815674,8.395770072937012
microkitchen1_7,20,3,12,8,-0.4664933681488037,8.466493606567383
microkitchen1_7,20,4,12,8,1.1280317306518555,6.8719682693481445
microkitchen1_7,20,5,13,7,-1.0118154287338257,8.011815071105957
microkitchen1_7,20,6,12,8,-0.37737172842025757,8.377371788024902
microkitchen1_7,20,7,12,8,-0.5339057445526123,8.533905982971191
microkitchen1_8,29,1,0,29,42.765811920166016,13.765811920166016
microkitchen1_8,29,2,43,-14,-5.476515293121338,8.52348518371582
microkitchen1_8,29,3,38,-9,0.6856185793876648,9.68561840057373
microkitchen1_8,29,4,39,-10,-4.136076927185059,5.863923072814941
microkitchen1_8,29,5,35,-6,-2.727046251296997,3.272953748703003
microkitchen1_8,29,6,32,-3,-0.5148013234138489,2.485198736190796
microkitchen1_9,19,1,0,19,8.080095291137695,10.919904708862305
microkitchen1_9,19,2,8,11,5.572183609008789,5.427816390991211
microkitchen1_9,19,3,14,5,1.1703064441680908,3.829693555831909
microkitchen1_9,19,4,15,4,1.4459235668182373,2.5540764331817627
pillowroom1_0,25,1,0,25,20.570119857788086,4.429880142211914
pillowroom1_0,25,2,21,4,20.842214584350586,16.842214584350586
pillowroom1_0,25,3,42,-17,-1.8092821836471558,15.190717697143555
pillowroom1_0,25,4,40,-15,4.321230411529541,19.321229934692383
pillowroom1_0,25,5,44,-19,1.0537632703781128,20.053762435913086
pillowroom1_0,25,6,45,-20,1.2572306394577026,21.257230758666992
pillowroom1_0,25,7,46,-21,1.568750023841858,22.568750381469727
pillowroom1_6,27,1,0,27,27.67664909362793,0.6766490936279297
pillowroom1_7,36,1,6,30,13.420614242553711,16.57938575744629
pillowroom1_7,36,2,19,17,18.751707077026367,1.7517070770263672
pillowroom1_8,34,1,4,30,23.788415908813477,6.211584091186523
pillowroom1_8,34,2,28,6,8.009377479553223,2.0093774795532227
pillowroom1_9,21,1,0,21,5.707528114318848,15.292471885681152
pillowroom1_9,21,2,6,15,3.5501439571380615,11.44985580444336
pillowroom1_9,21,3,10,11,4.371768474578857,6.628231525421143
pillowroom1_9,21,4,14,7,10.590025901794434,3.5900259017944336
pillowroom1_9,21,5,25,-4,-3.469730854034424,0.5302691459655762
secondfloorgames_0,20,1,0,20,24.70125389099121,4.701253890991211
secondfloorgames_0,20,2,25,-5,-5.977658748626709,0.977658748626709
secondfloorgames_1,24,1,0,24,5.298886775970459,18.701112747192383
secondfloorgames_1,24,2,5,19,6.965909481048584,12.034090042114258
secondfloorgames_1,24,3,12,12,-13.877267837524414,25.877267837524414
secondfloorgames_1,24,4,0,24,-9.082269668579102,33.08226776123047
secondfloorgames_1,24,5,0,24,-1.4476107358932495,25.44761085510254
secondfloorgames_1,24,6,0,24,-12.412919998168945,36.41291809082031
secondfloorgames_1,24,7,0,24,5.460827350616455,18.539173126220703
secondfloorgames_2,30,1,0,30,14.575479507446289,15.424520492553711
secondfloorgames_2,30,2,15,15,9.53368091583252,5.4663190841674805
secondfloorgames_2,30,3,25,5,-0.14778855443000793,5.1477885246276855
secondfloorgames_2,30,4,25,5,3.120929002761841,1.8790709972381592
secondfloorgames_3,23,1,0,23,29.28658103942871,6.286581039428711
secondfloorgames_3,23,2,29,-6,-7.734243869781494,1.7342438697814941
secondfloorgames_4,22,1,0,22,14.026632308959961,7.973367691040039
secondfloorgames_4,22,2,14,8,4.6058526039123535,3.3941473960876465
secondfloorgames_4,22,3,19,3,-2.1575565338134766,5.157556533813477
secondfloorgames_4,22,4,17,5,1.9619166851043701,3.03808331489563
secondfloorgames_4,22,5,19,3,-3.4772589206695557,6.477258682250977
secondfloorgames_4,22,6,16,6,1.658242106437683,4.341757774353027
secondfloorgames_4,22,7,18,4,-3.248215436935425,7.248215675354004
secondfloorgames_5,24,1,0,24,21.333951950073242,2.666048049926758
secondfloorgames_6,19,1,0,19,28.831151962280273,9.831151962280273
secondfloorgames_6,19,2,29,-10,11.183433532714844,21.183433532714844
secondfloorgames_6,19,3,40,-21,9.46542739868164,30.46542739868164
secondfloorgames_6,19,4,48,-29,-8.204170227050781,20.79582977294922
secondfloorgames_6,19,5,40,-21,11.661672592163086,32.66167449951172
secondfloorgames_6,19,6,48,-29,22.245668411254883,51.24566650390625
secondfloorgames_6,19,7,48,-29,0.5161788463592529,29.516178131103516
secondfloorgames_7,20,1,0,20,15.945396423339844,4.054603576660156
secondfloorgames_7,20,2,16,4,10.310046195983887,6.310046195983887
secondfloorgames_7,20,3,26,-6,-3.498485565185547,2.501514434814453
secondfloorgames_8,23,1,0,23,14.814976692199707,8.185023307800293
secondfloorgames_8,23,2,15,8,6.336026191711426,1.6639738082885742
apt1_0,25,1,0,25,22.406049728393555,2.5939502716064453
apt1_1,21,1,0,21,12.523324012756348,8.476675987243652
apt1_1,21,2,13,8,1.5044652223587036,6.495534896850586
apt1_1,21,3,15,6,3.1840875148773193,2.8159124851226807
apt1_2,24,1,0,24,18.050460815429688,5.9495391845703125
apt1_2,24,2,18,6,-1.6846754550933838,7.684675216674805
apt1_2,24,3,16,8,-2.3002769947052,10.300276756286621
apt1_2,24,4,14,10,-2.0056204795837402,12.005620956420898
apt1_2,24,5,12,12,3.531829357147217,8.468170166015625
apt1_2,24,6,16,8,-0.5227381587028503,8.522738456726074
apt1_2,24,7,15,9,-3.3127310276031494,12.31273078918457
apt1_3,25,1,0,25,12.473387718200684,12.526612281799316
apt1_3,25,2,12,13,8.477864265441895,4.5221357345581055
apt1_3,25,3,20,5,-1.2264025211334229,6.226402282714844
apt1_3,25,4,19,6,7.8763298988342285,1.8763298988342285
apt1_4,23,1,0,23,1.4865635633468628,21.513437271118164
apt1_4,23,2,1,22,3.3939712047576904,18.606029510498047
apt1_4,23,3,4,19,4.049188137054443,14.950811386108398
apt1_4,23,4,8,15,2.6407015323638916,12.359298706054688
apt1_4,23,5,11,12,4.054935932159424,7.945064067840576
apt1_4,23,6,15,8,2.7332963943481445,5.2667036056518555
apt1_4,23,7,18,5,1.3014428615570068,3.698557138442993
apt1_5,22,1,0,22,3.5882999897003174,18.411699295043945
apt1_5,22,2,4,18,-2.843029737472534,20.843029022216797
apt1_5,22,3,1,21,4.994781970977783,16.005218505859375
apt1_5,22,4,6,16,3.624537944793701,12.37546157836914
apt1_5,22,5,10,12,1.7187633514404297,10.28123664855957
apt1_5,22,6,12,10,4.785820960998535,5.214179039001465
apt1_5,22,7,17,5,0.9738187789916992,4.026181221008301
apt1_6,20,1,0,20,12.239297866821289,7.760702133178711
apt1_6,20,2,12,8,6.431172847747803,1.5688271522521973
apt1_7,20,1,0,20,7.047493934631348,12.952506065368652
apt1_7,20,2,7,13,7.420698165893555,5.579301834106445
apt1_7,20,3,14,6,1.2126246690750122,4.787375450134277
apt1_7,20,4,15,5,-3.577641010284424,8.577640533447266
apt1_7,20,5,11,9,5.713817596435547,3.286182403564453
apt1_7,20,6,17,3,-4.596856594085693,7.596856594085693
apt1_7,20,7,12,8,4.500791549682617,3.499208450317383
apt1_8,31,1,1,30,36.42378616333008,6.423786163330078
apt1_8,31,2,37,-6,5.37270450592041,11.37270450592041
apt1_8,31,3,42,-11,0.7901310324668884,11.790130615234375
apt1_8,31,4,43,-12,-9.55721378326416,2.44278621673584
apt1_9,20,1,0,20,18.068174362182617,1.9318256378173828
apt2_0,41,1,11,30,25.79261016845703,4.207389831542969
apt2_0,41,2,37,4,2.4624979496002197,1.5375020503997803
apt2_1,20,1,0,20,17.944625854492188,2.0553741455078125
apt2_2,23,1,0,23,9.352227210998535,13.647772789001465
apt2_2,23,2,9,14,10.236388206481934,3.7636117935180664
apt2_2,23,3,19,4,5.002096652984619,1.0020966529846191
apt2_3,26,1,0,26,18.065635681152344,7.934364318847656
apt2_3,26,2,18,8,12.659919738769531,4.659919738769531
apt2_3,26,3,31,-5,0.9393359422683716,5.939335823059082
apt2_3,26,4,32,-6,3.2716689109802246,9.271669387817383
apt2_3,26,5,35,-9,5.045019149780273,14.045019149780273
apt2_3,26,6,40,-14,15.708104133605957,29.70810317993164
apt2_3,26,7,48,-22,9.113936424255371,31.113937377929688
apt2_4,23,1,0,23,17.186248779296875,5.813751220703125
apt2_4,23,2,17,6,1.1127194166183472,4.887280464172363
apt2_4,23,3,18,5,-0.16003018617630005,5.160030364990234
apt2_4,23,4,18,5,-4.094384670257568,9.094385147094727
apt2_4,23,5,14,9,0.4316820204257965,8.568318367004395
apt2_4,23,6,14,9,5.0267767906188965,3.9732232093811035
apt2_4,23,7,19,4,-0.11018485575914383,4.110184669494629
apt2_5,26,1,0,26,14.297087669372559,11.702912330627441
apt2_5,26,2,14,12,3.4983880519866943,8.501611709594727
apt2_5,26,3,17,9,3.238468647003174,5.761531352996826
apt2_5,26,4,20,6,3.103041410446167,2.896958589553833
apt2_6,23,1,0,23,0.1570383459329605,22.84296226501465
apt2_6,23,2,0,23,-9.399062156677246,32.39906311035156
apt2_6,23,3,0,23,0.9886184930801392,22.011381149291992
apt2_6,23,4,1,22,2.1767961978912354,19.823204040527344
apt2_6,23,5,3,20,6.105749607086182,13.894250869750977
apt2_6,23,6,9,14,9.824203491210938,4.1757965087890625
apt2_6,23,7,19,4,-6.770712375640869,10.770711898803711
apt2_7,31,1,1,30,27.877092361450195,2.1229076385498047
apt2_8,40,1,10,30,14.784663200378418,15.215336799621582
apt2_8,40,2,25,15,10.834837913513184,4.165162086486816
apt2_8,40,3,36,4,5.2153096199035645,1.2153096199035645
apt2_9,24,1,0,24,25.965532302856445,1.9655323028564453
books_0,27,1,0,27,23.04148292541504,3.958517074584961
books_0,27,2,23,4,4.4703593254089355,0.47035932540893555
books_1,26,1,0,26,7.940334796905518,18.05966567993164
books_1,26,2,8,18,10.804085731506348,7.195914268493652
books_1,26,3,19,7,3.949230432510376,3.050769567489624
books_1,26,4,23,3,-7.318378448486328,10.318378448486328
books_1,26,5,16,10,8.461240768432617,1.5387592315673828
books_2,22,1,0,22,11.196319580078125,10.803680419921875
books_2,22,2,11,11,5.021683216094971,5.978316783905029
books_2,22,3,16,6,5.211228370666504,0.7887716293334961
books_3,23,1,0,23,19.305885314941406,3.6941146850585938
books_3,23,2,19,4,-2.7104697227478027,6.710469722747803
books_3,23,3,16,7,4.082276821136475,2.9177231788635254
books_4,24,1,0,24,16.01634979248047,7.983650207519531
books_4,24,2,16,8,7.135049343109131,0.8649506568908691
books_5,22,1,0,22,10.672415733337402,11.327584266662598
books_5,22,2,11,11,9.314774513244629,1.685225486755371
books_6,20,1,0,20,12.06587028503418,7.93412971496582
books_6,20,2,12,8,5.4961748123168945,2.5038251876831055
books_7,26,1,0,26,3.5742435455322266,22.425756454467773
books_7,26,2,4,22,6.201479434967041,15.798521041870117
books_7,26,3,10,16,3.164952039718628,12.835047721862793
books_7,26,4,13,13,4.834989070892334,8.165010452270508
books_7,26,5,18,8,-0.07391873002052307,8.073918342590332
books_7,26,6,18,8,4.277383327484131,3.722616672515869
books_7,26,7,22,4,5.82484769821167,1.82484769821167
books_8,23,1,0,23,2.599632978439331,20.400367736816406
books_8,23,2,3,20,6.394533634185791,13.605466842651367
books_8,23,3,9,14,1.9263556003570557,12.073644638061523
books_8,23,4,11,12,6.422945976257324,5.577054023742676
books_8,23,5,17,6,4.496511936187744,1.5034880638122559
books_9,27,1,0,27,30.536903381347656,3.5369033813476562
books_9,27,2,31,-4,3.395512104034424,7.395512104034424
books_9,27,3,34,-7,-1.0431413650512695,5.9568586349487305
books_9,27,4,33,-6,-3.776197671890259,2.223802328109741
bottles_0,22,1,0,22,7.201784610748291,14.798215866088867
bottles_0,22,2,7,15,6.84606409072876,8.153936386108398
bottles_0,22,3,14,8,5.6583967208862305,2.3416032791137695
bottles_1,23,1,0,23,10.815864562988281,12.184135437011719
bottles_1,23,2,11,12,3.3070240020751953,8.692975997924805
bottles_1,23,3,14,9,-3.2574942111968994,12.25749397277832
bottles_1,23,4,11,12,3.787029504776001,8.212970733642578
bottles_1,23,5,15,8,0.7189407348632812,7.281059265136719
bottles_1,23,6,16,7,-5.362370491027832,12.362370491027832
bottles_1,23,7,11,12,0.9589729309082031,11.041027069091797
bottles_2,22,1,0,22,39.608314514160156,17.608314514160156
bottles_2,22,2,40,-18,-29.102678298950195,11.102678298950195
bottles_2,22,3,11,11,16.664857864379883,5.664857864379883
bottles_2,22,4,28,-6,-13.602473258972168,7.602473258972168
bottles_2,22,5,14,8,4.343468189239502,3.656531810760498
bottles_2,22,6,18,4,3.446260452270508,0.5537395477294922
bottles_3,30,1,0,30,32.28108215332031,2.2810821533203125
bottles_4,25,1,0,25,28.58499526977539,3.5849952697753906
bottles_4,25,2,29,-4,4.399436950683594,8.399436950683594
bottles_4,25,3,33,-8,0.7918580770492554,8.791857719421387
bottles_4,25,4,34,-9,-5.792828559875488,3.2071714401245117
bottles_4,25,5,28,-3,2.811087131500244,5.811087131500244
bottles_4,25,6,31,-6,-0.06623263657093048,5.933767318725586
bottles_4,25,7,31,-6,2.0149154663085938,8.014915466308594
bottles_5,27,1,0,27,13.975005149841309,13.024994850158691
bottles_5,27,2,14,13,5.89522123336792,7.10477876663208
bottles_5,27,3,20,7,6.593864917755127,0.40613508224487305
bottles_6,27,1,0,27,19.542156219482422,7.457843780517578
bottles_6,27,2,20,7,5.262327671051025,1.7376723289489746
bottles_7,27,1,0,27,15.17001724243164,11.82998275756836
bottles_7,27,2,15,12,15.715563774108887,3.7155637741088867
bottles_7,27,3,31,-4,-4.993499755859375,0.993499755859375
bottles_8,25,1,0,25,22.001771926879883,2.998228073120117
campusoutdoors1_0,20,1,0,20,9.493918418884277,10.506081581115723
campusoutdoors1_0,20,2,9,11,1.7065397500991821,9.29345989227295
campusoutdoors1_0,20,3,11,9,1.1247758865356445,7.8752241134643555
campusoutdoors1_0,20,4,12,8,-6.413036346435547,14.413036346435547
campusoutdoors1_0,20,5,6,14,7.550356864929199,6.449643135070801
campusoutdoors1_0,20,6,14,6,-4.876677989959717,10.876678466796875
campusoutdoors1_0,20,7,9,11,-0.4498072564601898,11.449807167053223
campusoutdoors1_1,20,1,0,20,24.963462829589844,4.963462829589844
campusoutdoors1_1,20,2,25,-5,-16.874540328979492,11.874540328979492
campusoutdoors1_1,20,3,8,12,19.852144241333008,7.852144241333008
campusoutdoors1_1,20,4,28,-8,-28.32648468017578,20.32648468017578
campusoutdoors1_1,20,5,0,20,32.94914245605469,12.949142456054688
campusoutdoors1_1,20,6,33,-13,-15.741101264953613,2.7411012649536133
campusoutdoors1_2,22,1,0,22,16.82809829711914,5.171901702880859
campusoutdoors1_2,22,2,17,5,-2.2931292057037354,7.293128967285156
campusoutdoors1_2,22,3,15,7,2.6597914695739746,4.340208530426025
campusoutdoors1_2,22,4,18,4,0.28055885434150696,3.7194411754608154
campusoutdoors1_2,22,5,18,4,4.491798400878906,0.49179840087890625
campusoutdoors1_3,20,1,0,20,7.273614883422852,12.726385116577148
campusoutdoors1_3,20,2,7,13,1.052499771118164,11.947500228881836
campusoutdoors1_3,20,3,8,12,2.3586111068725586,9.641388893127441
campusoutdoors1_3,20,4,10,10,-0.5943108797073364,10.594310760498047
campusoutdoors1_3,20,5,9,11,-3.0077333450317383,14.007733345031738
campusoutdoors1_3,20,6,6,14,4.793950080871582,9.206049919128418
campusoutdoors1_3,20,7,11,9,-2.2858152389526367,11.285815238952637
campusoutdoors1_4,22,1,0,22,10.32193374633789,11.67806625366211
campusoutdoors1_4,22,2,10,12,7.719915390014648,4.280084609985352
campusoutdoors1_4,22,3,18,4,0.19934894144535065,3.8006510734558105
campusoutdoors1_4,22,4,18,4,3.6033363342285156,0.3966636657714844
campusoutdoors1_5,22,1,0,22,12.478961944580078,9.521038055419922
campusoutdoors1_5,22,2,12,10,4.301267623901367,5.698732376098633
campusoutdoors1_5,22,3,16,6,0.5840465426445007,5.415953636169434
campusoutdoors1_5,22,4,17,5,1.1223496198654175,3.877650260925293
campusoutdoors1_5,22,5,18,4,-3.8793413639068604,7.879341125488281
campusoutdoors1_5,22,6,14,8,4.412974834442139,3.5870251655578613
campusoutdoors1_5,22,7,18,4,10.469773292541504,6.469773292541504
campusoutdoors1_6,27,1,0,27,24.80449676513672,2.1955032348632812
campusoutdoors1_8,19,1,0,19,7.702631950378418,11.297368049621582
campusoutdoors1_8,19,2,8,11,1.9353315830230713,9.064668655395508
campusoutdoors1_8,19,3,10,9,-0.45548394322395325,9.455484390258789
campusoutdoors1_8,19,4,10,9,1.5134333372116089,7.486566543579102
campusoutdoors1_8,19,5,12,7,-0.7578209042549133,7.757821083068848
campusoutdoors1_8,19,6,11,8,2.900853157043457,5.099146842956543
campusoutdoors1_8,19,7,14,5,5.020285129547119,0.02028512954711914
campusoutdoors1_9,19,1,0,19,16.405946731567383,2.594053268432617
campusoutdoors2_0,20,1,0,20,6.4864726066589355,13.513526916503906
campusoutdoors2_0,20,2,6,14,5.422461986541748,8.577537536621094
campusoutdoors2_0,20,3,11,9,0.5935990214347839,8.406400680541992
campusoutdoors2_0,20,4,12,8,-2.0487115383148193,10.048711776733398
campusoutdoors2_0,20,5,10,10,-2.552633762359619,12.552633285522461
campusoutdoors2_0,20,6,7,13,1.658658742904663,11.341341018676758
campusoutdoors2_0,20,7,9,11,1.2090734243392944,9.790926933288574
campusoutdoors2_1,42,1,12,30,25.55860710144043,4.44139289855957
campusoutdoors2_1,42,2,38,4,5.961888313293457,1.961888313293457
campusoutdoors2_3,31,1,1,30,16.190671920776367,13.809328079223633
campusoutdoors2_3,31,2,17,14,4.777952194213867,9.222047805786133
campusoutdoors2_3,31,3,22,9,4.039371490478516,4.960628509521484
campusoutdoors2_3,31,4,26,5,0.7329670190811157,4.267033100128174
campusoutdoors2_3,31,5,27,4,-2.165682315826416,6.165682315826416
campusoutdoors2_3,31,6,25,6,2.507164716720581,3.492835283279419
campusoutdoors2_3,31,7,28,3,1.2672172784805298,1.7327827215194702
campusoutdoors2_4,29,1,0,29,19.435056686401367,9.564943313598633
campusoutdoors2_4,29,2,19,10,7.030529975891113,2.9694700241088867
campusoutdoors2_5,32,1,2,30,12.68152141571045,17.318477630615234
campusoutdoors2_5,32,2,15,17,17.103134155273438,0.1031341552734375
campusoutdoors2_6,22,1,0,22,17.830577850341797,4.169422149658203
campusoutdoors2_6,22,2,18,4,15.182571411132812,11.182571411132812
campusoutdoors2_6,22,3,33,-11,7.305846214294434,18.30584716796875
campusoutdoors2_6,22,4,40,-18,7.90082311630249,25.90082359313965
campusoutdoors2_6,22,5,48,-26,13.739447593688965,39.73944854736328
campusoutdoors2_6,22,6,48,-26,0.1185579001903534,26.11855697631836
campusoutdoors2_6,22,7,48,-26,4.303513526916504,30.303512573242188
campusoutdoors2_7,23,1,0,23,8.014971733093262,14.985028266906738
campusoutdoors2_7,23,2,8,15,15.379964828491211,0.37996482849121094
campusoutdoors2_8,23,1,0,23,20.196491241455078,2.803508758544922
campusoutdoors2_9,25,1,0,25,22.425376892089844,2.5746231079101562
fakeplants_0,24,1,0,24,9.252800941467285,14.747199058532715
fakeplants_0,24,2,9,15,3.137205123901367,11.862794876098633
fakeplants_0,24,3,12,12,7.4382805824279785,4.5617194175720215
fakeplants_0,24,4,19,5,4.010231971740723,0.9897680282592773
fakeplants_1,21,1,0,21,10.821789741516113,10.178210258483887
fakeplants_1,21,2,11,10,7.085902690887451,2.914097309112549
fakeplants_2,21,1,0,21,9.382712364196777,11.617287635803223
fakeplants_2,21,2,9,12,5.790197372436523,6.209802627563477
fakeplants_2,21,3,15,6,5.132620811462402,0.8673791885375977
fakeplants_3,22,1,0,22,8.889732360839844,13.110267639160156
fakeplants_3,22,2,9,13,3.722639560699463,9.277360916137695
fakeplants_3,22,3,13,9,2.4529147148132324,6.547085285186768
fakeplants_3,22,4,15,7,2.237269878387451,4.762730121612549
fakeplants_3,22,5,17,5,4.490214824676514,0.5097851753234863
fakeplants_4,24,1,0,24,24.171152114868164,0.17115211486816406
fakeplants_5,21,1,0,21,36.606285095214844,15.606285095214844
fakeplants_5,21,2,37,-16,-2.4332010746002197,13.56679916381836
fakeplants_5,21,3,35,-14,2.1579947471618652,16.157995223999023
fakeplants_5,21,4,37,-16,-3.6031785011291504,12.396821975708008
fakeplants_5,21,5,33,-12,-5.391360759735107,6.608639240264893
fakeplants_5,21,6,28,-7,0.13247954845428467,7.132479667663574
fakeplants_5,21,7,28,-7,-5.168056964874268,1.8319430351257324
fakeplants_6,21,1,0,21,22.82656478881836,1.8265647888183594
fakeplants_7,23,1,0,23,17.454530715942383,5.545469284057617
fakeplants_7,23,2,17,6,5.31761360168457,0.6823863983154297
fakeplants_8,21,1,0,21,21.37705421447754,0.37705421447753906
fakeplants_9,21,1,0,21,24.582998275756836,3.582998275756836
fakeplants_9,21,2,25,-4,-6.271372318267822,2.2713723182678223
garage2_0,22,1,0,22,15.052413940429688,6.9475860595703125
garage2_0,22,2,15,7,6.187243461608887,0.8127565383911133
garage2_1,24,1,0,24,19.653125762939453,4.346874237060547
garage2_1,24,2,20,4,-0.329706609249115,4.32970666885376
garage2_1,24,3,20,4,-0.45766547322273254,4.45766544342041
garage2_1,24,4,20,4,1.5801857709884644,2.419814109802246
garage2_2,31,1,1,30,28.35457420349121,1.645425796508789
garage2_4,24,1,0,24,29.649471282958984,5.649471282958984
garage2_4,24,2,30,-6,-7.085991382598877,1.085991382598877
garage2_6,26,1,0,26,26.030227661132812,0.0302276611328125
garage2_7,24,1,0,24,14.623517036437988,9.376482963562012
garage2_7,24,2,15,9,5.356414794921875,3.643585205078125
garage2_7,24,3,20,4,-1.1528733968734741,5.152873516082764
garage2_7,24,4,19,5,4.284461498260498,0.715538501739502
garage2_8,21,1,0,21,17.667444229125977,3.3325557708740234
garage2_8,21,2,18,3,0.4753224849700928,2.5246775150299072
garage2_9,23,1,0,23,8.357659339904785,14.642340660095215
garage2_9,23,2,8,15,4.481400489807129,10.518599510192871
garage2_9,23,3,12,11,6.438947677612305,4.561052322387695
garage2_9,23,4,18,5,-3.5209593772888184,8.520959854125977
garage2_9,23,5,14,9,-4.524718761444092,13.52471923828125
garage2_9,23,6,9,14,1.2983067035675049,12.701693534851074
garage2_9,23,7,10,13,-0.04794715344905853,13.04794692993164
garage_0,25,1,0,25,13.083195686340332,11.916804313659668
garage_0,25,2,13,12,7.552736759185791,4.447263240814209
garage_0,25,3,21,4,0.07233808189630508,3.927661895751953
garage_0,25,4,21,4,6.982327938079834,2.982327938079834
garage_1,27,1,0,27,2.85347318649292,24.146526336669922
garage_1,27,2,3,24,3.7532055377960205,20.246793746948242
garage_1,27,3,7,20,-5.693463325500488,25.693462371826172
garage_1,27,4,1,26,-0.011311332695186138,26.011310577392578
garage_1,27,5,1,26,5.084998607635498,20.915000915527344
garage_1,27,6,6,21,7.814297199249268,13.18570327758789
garage_1,27,7,14,13,-1.3333263397216797,14.33332633972168
garage_3,22,1,0,22,11.412481307983398,10.587518692016602
garage_3,22,2,11,11,7.889055252075195,3.1109447479248047
garage_3,22,3,19,3,-0.9874055981636047,3.98740553855896
garage_3,22,4,18,4,2.9245691299438477,1.0754308700561523
garage_4,44,1,14,30,8.711074829101562,21.288925170898438
garage_4,44,2,23,21,8.37470531463623,12.62529468536377
garage_4,44,3,31,13,5.296907901763916,7.703092098236084
garage_4,44,4,36,8,-1.637630820274353,9.637630462646484
garage_4,44,5,34,10,5.798018455505371,4.201981544494629
garage_4,44,6,40,4,-4.17188835144043,8.17188835144043
garage_4,44,7,36,8,4.084155559539795,3.915844440460205
garage_6,27,1,0,27,11.529955863952637,15.470044136047363
garage_6,27,2,12,15,8.144927978515625,6.855072021484375
garage_6,27,3,20,7,1.6750705242156982,5.324929237365723
garage_6,27,4,22,5,0.026439180597662926,4.973560810089111
garage_6,27,5,22,5,6.011184215545654,1.0111842155456543
garage_7,22,1,0,22,15.724441528320312,6.2755584716796875
garage_7,22,2,16,6,9.233488082885742,3.233488082885742
garage_7,22,3,25,-3,-2.122952938079834,0.877047061920166
garage_8,44,1,14,30,39.30939483642578,9.309394836425781
garage_8,44,2,48,-4,-6.176068305969238,2.1760683059692383
garage_9,20,1,0,20,13.513547897338867,6.486452102661133
garage_9,20,2,14,6,7.808605194091797,1.8086051940917969
hallway1_0,32,1,2,30,19.99050521850586,10.00949478149414
hallway1_0,32,2,22,10,8.533408164978027,1.4665918350219727
hallway1_2,33,1,3,30,26.634328842163086,3.365671157836914
hallway1_2,33,2,30,3,8.90987777709961,5.909877777099609
hallway1_2,33,3,39,-6,2.1016769409179688,8.101676940917969
hallway1_2,33,4,41,-8,-7.462937355041504,0.5370626449584961
hallway1_3,26,1,0,26,11.205643653869629,14.794356346130371
hallway1_3,26,2,11,15,8.262140274047852,6.737859725952148
hallway1_3,26,3,19,7,1.4276517629623413,5.572348117828369
hallway1_3,26,4,20,6,1.2257075309753418,4.774292469024658
hallway1_3,26,5,21,5,0.9693323373794556,4.030667781829834
hallway1_3,26,6,22,4,2.340374708175659,1.6596252918243408
hallway1_4,23,1,0,23,15.87431812286377,7.1256818771362305
hallway1_4,23,2,16,7,5.718690872192383,1.2813091278076172
hallway1_5,22,1,0,22,11.07819938659668,10.92180061340332
hallway1_5,22,2,11,11,5.035964012145996,5.964035987854004
hallway1_5,22,3,16,6,0.7329522967338562,5.267047882080078
hallway1_5,22,4,17,5,1.9838411808013916,3.0161588191986084
hallway1_5,22,5,19,3,1.1763049364089966,1.8236950635910034
hallway1_6,22,1,0,22,15.924714088439941,6.075285911560059
hallway1_6,22,2,16,6,1.9286731481552124,4.071326732635498
hallway1_6,22,3,18,4,2.616774082183838,1.383225917816162
hallway1_7,37,1,7,30,29.601791381835938,0.3982086181640625
hallway2_0,29,1,0,29,35.00323486328125,6.00323486328125
hallway2_0,29,2,35,-6,4.434803485870361,10.434803009033203
hallway2_0,29,3,39,-10,4.816608905792236,14.816608428955078
hallway2_0,29,4,44,-15,-3.743577480316162,11.25642204284668
hallway2_0,29,5,40,-11,-2.852738857269287,8.147260665893555
hallway2_0,29,6,37,-8,0.05755326896905899,8.0575532913208
hallway2_0,29,7,37,-8,1.084431529045105,9.084431648254395
hallway2_1,34,1,4,30,3.9374806880950928,26.062519073486328
hallway2_1,34,2,8,26,1.043930172920227,24.956069946289062
hallway2_1,34,3,9,25,4.290280342102051,20.709720611572266
hallway2_1,34,4,13,21,3.555802822113037,17.444196701049805
hallway2_1,34,5,17,17,2.2399675846099854,14.760032653808594
hallway2_1,34,6,19,15,4.3040056228637695,10.69599437713623
hallway2_1,34,7,23,11,2.6369175910949707,8.363082885742188
hallway2_2,25,1,0,25,21.534433364868164,3.465566635131836
hallway2_2,25,2,22,3,16.269428253173828,13.269428253173828
hallway2_2,25,3,38,-13,-7.705726146697998,5.294273853302002
hallway2_2,25,4,30,-5,-6.3470048904418945,1.3470048904418945
meetingroom1_7,19,1,0,19,22.62403106689453,3.6240310668945312
meetingroom1_7,19,2,23,-4,21.97264289855957,25.97264289855957
meetingroom1_7,19,3,45,-26,31.910324096679688,57.91032409667969
meetingroom1_7,19,4,48,-29,1.11919105052948,30.119190216064453
meetingroom1_7,19,5,48,-29,3.260817050933838,32.26081848144531
meetingroom1_7,19,6,48,-29,20.247739791870117,49.24774169921875
meetingroom1_7,19,7,48,-29,21.5140323638916,50.51403045654297
meetingroom1_8,21,1,0,21,23.375473022460938,2.3754730224609375
meetingroom1_9,23,1,0,23,43.501041412353516,20.501041412353516
meetingroom1_9,23,2,44,-21,-26.23724937438965,5.237249374389648
meetingroom1_9,23,3,18,5,4.136321067810059,0.8636789321899414
meetingroom2_0,27,1,0,27,6.608191013336182,20.391809463500977
meetingroom2_0,27,2,7,20,2.9420034885406494,17.05799674987793
meetingroom2_0,27,3,10,17,5.3871073722839355,11.612892150878906
meetingroom2_0,27,4,15,12,4.145817756652832,7.854182243347168
meetingroom2_0,27,5,19,8,-0.8076052069664001,8.807604789733887
meetingroom2_0,27,6,18,9,6.5079121589660645,2.4920878410339355
meetingroom2_1,23,1,0,23,21.227262496948242,1.7727375030517578
meetingroom2_2,24,1,0,24,10.54677963256836,13.45322036743164
meetingroom2_2,24,2,11,13,5.614857196807861,7.385142803192139
meetingroom2_2,24,3,17,7,4.249833106994629,2.750166893005371
meetingroom2_3,29,1,0,29,6.871423721313477,22.128576278686523
meetingroom2_3,29,2,7,22,8.029879570007324,13.970120429992676
meetingroom2_3,29,3,15,14,2.973353385925293,11.026646614074707
meetingroom2_3,29,4,18,11,1.8316221237182617,9.168377876281738
meetingroom2_3,29,5,20,9,4.180113315582275,4.819886684417725
meetingroom2_3,29,6,24,5,0.28801292181015015,4.711987018585205
meetingroom2_3,29,7,24,5,0.08945363759994507,4.91054630279541
meetingroom2_4,22,1,0,22,1.1514970064163208,20.84850311279297
meetingroom2_4,22,2,1,21,4.803191661834717,16.196807861328125
meetingroom2_4,22,3,6,16,-1.1314386129379272,17.131439208984375
meetingroom2_4,22,4,5,17,7.567069053649902,9.432930946350098
meetingroom2_4,22,5,13,9,2.2354516983032227,6.764548301696777
meetingroom2_4,22,6,15,7,4.969644546508789,2.030355453491211
meetingroom2_5,24,1,0,24,0.2729381322860718,23.727062225341797
meetingroom2_5,24,2,0,24,5.599607467651367,18.400392532348633
meetingroom2_5,24,3,6,18,5.916959762573242,12.083040237426758
meetingroom2_5,24,4,12,12,4.973042964935303,7.026957035064697
meetingroom2_5,24,5,17,7,4.662210464477539,2.337789535522461
meetingroom2_6,26,1,0,26,17.2531681060791,8.746831893920898
meetingroom2_6,26,2,17,9,13.06605052947998,4.0660505294799805
meetingroom2_6,26,3,30,-4,-9.711067199707031,5.711067199707031
meetingroom2_6,26,4,20,6,11.464537620544434,5.464537620544434
meetingroom2_6,26,5,31,-5,-7.655467510223389,2.6554675102233887
meetingroom2_7,28,1,0,28,23.8863582611084,4.113641738891602
meetingroom2_7,28,2,24,4,7.460650444030762,3.4606504440307617
meetingroom2_7,28,3,31,-3,6.495162010192871,9.495162010192871
meetingroom2_7,28,4,37,-9,-2.933161735534668,6.066838264465332
meetingroom2_7,28,5,34,-6,7.243219375610352,13.243219375610352
meetingroom2_7,28,6,41,-13,-16.432357788085938,3.4323577880859375
meetingroom2_7,28,7,25,3,5.027477741241455,2.027477741241455
meetingroom2_8,28,1,0,28,42.47809600830078,14.478096008300781
meetingroom2_8,28,2,42,-14,-11.195358276367188,2.8046417236328125
meetingroom2_9,31,1,1,30,25.358125686645508,4.641874313354492
meetingroom2_9,31,2,26,5,3.148078203201294,1.851921796798706
officecrawl1_0,26,1,0,26,-0.2857734262943268,26.28577423095703
officecrawl1_0,26,2,0,26,-3.100972890853882,29.10097312927246
officecrawl1_0,26,3,0,26,-9.216690063476562,35.21669006347656
officecrawl1_0,26,4,0,26,-4.973110198974609,30.97311019897461
officecrawl1_0,26,5,0,26,-6.897522926330566,32.89752197265625
officecrawl1_0,26,6,0,26,-7.373803615570068,33.373802185058594
officecrawl1_0,26,7,0,26,3.906581163406372,22.09341812133789
officecrawl1_1,36,1,6,30,13.620565414428711,16.37943458557129
officecrawl1_1,36,2,20,16,8.003254890441895,7.9967451095581055
officecrawl1_1,36,3,28,8,5.2439188957214355,2.7560811042785645
officecrawl1_2,26,1,0,26,4.891716957092285,21.10828399658203
officecrawl1_2,26,2,5,21,7.845855236053467,13.154144287109375
officecrawl1_2,26,3,13,13,7.1544694900512695,5.8455305099487305
officecrawl1_2,26,4,20,6,6.758794784545898,0.7587947845458984
officecrawl1_3,21,1,0,21,-6.434370517730713,27.434370040893555
officecrawl1_3,21,2,0,21,5.041964054107666,15.958036422729492
officecrawl1_3,21,3,5,16,-6.281309604644775,22.281309127807617
officecrawl1_3,21,4,0,21,-5.6067352294921875,26.606735229492188
officecrawl1_3,21,5,0,21,8.45209789276123,12.54790210723877
officecrawl1_3,21,6,8,13,5.959599018096924,7.040400981903076
officecrawl1_3,21,7,14,7,-0.8751122951507568,7.875112533569336
officecrawl1_4,31,1,1,30,42.44251251220703,12.442512512207031
officecrawl1_4,31,2,43,-12,-7.568833827972412,4.431166172027588
officecrawl1_4,31,3,35,-4,3.4364848136901855,7.4364848136901855
officecrawl1_4,31,4,38,-7,7.9551262855529785,14.95512580871582
officecrawl1_4,31,5,46,-15,-7.989316463470459,7.010683536529541
officecrawl1_4,31,6,38,-7,-10.425660133361816,3.4256601333618164
officecrawl1_4,31,7,28,3,14.366808891296387,11.366808891296387
officecrawl1_5,23,1,0,23,5.237971782684326,17.762027740478516
officecrawl1_5,23,2,5,18,-0.8434054255485535,18.84340476989746
officecrawl1_5,23,3,4,19,-0.2718087434768677,19.271808624267578
officecrawl1_5,23,4,4,19,3.6389052867889404,15.36109447479248
officecrawl1_5,23,5,8,15,5.586236476898193,9.413763046264648
officecrawl1_5,23,6,14,9,-3.0180747509002686,12.018074989318848
officecrawl1_5,23,7,11,12,-5.90906286239624,17.9090633392334
officecrawl1_6,27,1,0,27,23.761920928955078,3.238079071044922
officecrawl1_6,27,2,24,3,11.06226921081543,8.06226921081543
officecrawl1_6,27,3,35,-8,15.245408058166504,23.245407104492188
officecrawl1_6,27,4,48,-21,13.44151496887207,34.44151306152344
officecrawl1_6,27,5,48,-21,23.617948532104492,44.617950439453125
officecrawl1_6,27,6,48,-21,6.16790771484375,27.16790771484375
officecrawl1_6,27,7,48,-21,0.3485233187675476,21.34852409362793
officecrawl1_7,20,1,0,20,29.924978256225586,9.924978256225586
officecrawl1_7,20,2,30,-10,5.690646648406982,15.69064712524414
officecrawl1_7,20,3,36,-16,-4.020413875579834,11.979585647583008
officecrawl1_7,20,4,32,-12,5.677129745483398,17.6771297454834
officecrawl1_7,20,5,38,-18,-4.428125858306885,13.571874618530273
officecrawl1_7,20,6,34,-14,-1.7589353322982788,12.24106502532959
officecrawl1_7,20,7,32,-12,4.123648166656494,16.123647689819336
officecrawl1_8,32,1,2,30,22.548870086669922,7.451129913330078
officecrawl1_8,32,2,25,7,13.035901069641113,6.035901069641113
officecrawl1_8,32,3,38,-6,-0.9090679883956909,5.0909318923950195
officecrawl1_8,32,4,37,-5,-2.9624311923980713,2.0375688076019287
officecrawl1_9,33,1,3,30,26.919864654541016,3.0801353454589844
officecrawl1_9,33,2,30,3,8.012519836425781,5.012519836425781
officecrawl1_9,33,3,38,-5,2.2581253051757812,7.258125305175781
officecrawl1_9,33,4,40,-7,-3.6321282386779785,3.3678717613220215
officecrawl1_9,33,5,36,-3,-3.4267184734344482,0.42671847343444824
officecrawl2_0,31,1,1,30,-4.641060829162598,34.64105987548828
officecrawl2_0,31,2,0,31,-0.21653760969638824,31.216537475585938
officecrawl2_0,31,3,0,31,-0.017228003591299057,31.017227172851562
officecrawl2_0,31,4,0,31,1.1196367740631104,29.88036346435547
officecrawl2_0,31,5,1,30,-1.961124300956726,31.961124420166016
officecrawl2_0,31,6,0,31,0.8602533936500549,30.139745712280273
officecrawl2_0,31,7,1,30,0.9862479567527771,29.013751983642578
officecrawl2_1,24,1,0,24,15.238336563110352,8.761663436889648
officecrawl2_1,24,2,15,9,6.7521748542785645,2.2478251457214355
officecrawl2_2,48,1,18,30,7.199260234832764,22.800739288330078
officecrawl2_2,48,2,25,23,5.2041096687316895,17.79589080810547
officecrawl2_2,48,3,30,18,4.981863975524902,13.018136024475098
officecrawl2_2,48,4,35,13,5.078249931335449,7.921750068664551
officecrawl2_2,48,5,40,8,2.764366626739502,5.235633373260498
officecrawl2_2,48,6,43,5,2.812704563140869,2.187295436859131
officecrawl2_3,42,1,12,30,27.193355560302734,2.8066444396972656
officecrawl2_4,24,1,0,24,5.397731304168701,18.60226821899414
officecrawl2_4,24,2,5,19,6.225007057189941,12.774992942810059
officecrawl2_4,24,3,11,13,5.19891881942749,7.80108118057251
officecrawl2_4,24,4,16,8,0.19504109025001526,7.804958820343018
officecrawl2_4,24,5,16,8,4.863654613494873,3.136345386505127
officecrawl2_4,24,6,21,3,-0.4195956289768219,3.419595718383789
officecrawl2_4,24,7,21,3,1.8365188837051392,1.1634811162948608
officecrawl2_6,28,1,0,28,7.073178768157959,20.926820755004883
officecrawl2_6,28,2,7,21,7.31815242767334,13.68184757232666
officecrawl2_6,28,3,14,14,7.127160549163818,6.872839450836182
officecrawl2_6,28,4,21,7,1.5079180002212524,5.492082118988037
officecrawl2_6,28,5,23,5,2.4559314250946045,2.5440685749053955
officecrawl2_7,33,1,3,30,26.18538475036621,3.814615249633789
officecrawl2_7,33,2,29,4,1.4392728805541992,2.560727119445801
officecrawl2_8,22,1,0,22,16.404069900512695,5.595930099487305
officecrawl2_8,22,2,16,6,5.605774879455566,0.3942251205444336
officecrawl2_9,27,1,0,27,4.725454807281494,22.274545669555664
officecrawl2_9,27,2,5,22,6.460302352905273,15.539697647094727
officecrawl2_9,27,3,11,16,5.45474100112915,10.545259475708008
officecrawl2_9,27,4,16,11,2.670217752456665,8.329782485961914
officecrawl2_9,27,5,19,8,6.453186511993408,1.5468134880065918
officecrawl3_1,26,1,0,26,24.49468231201172,1.5053176879882812
officecrawl3_2,24,1,0,24,25.485790252685547,1.4857902526855469
officecrawl3_3,32,1,2,30,14.854276657104492,15.145723342895508
officecrawl3_3,32,2,17,15,3.3521945476531982,11.647805213928223
officecrawl3_3,32,3,20,12,0.11007972806692123,11.889920234680176
officecrawl3_3,32,4,20,12,1.323279619216919,10.67672061920166
officecrawl3_3,32,5,21,11,3.637876033782959,7.362123966217041
officecrawl3_3,32,6,25,7,5.295194625854492,1.7048053741455078
officecrawl3_4,20,1,0,20,18.024614334106445,1.9753856658935547
officecrawl3_5,27,1,0,27,1.3481370210647583,25.65186309814453
officecrawl3_5,27,2,1,26,1.215087652206421,24.784912109375
officecrawl3_5,27,3,2,25,6.99970006942749,18.00029945373535
officecrawl3_5,27,4,9,18,5.050717353820801,12.9492826461792
officecrawl3_5,27,5,14,13,3.844003438949585,9.155996322631836
officecrawl3_5,27,6,18,9,7.086605072021484,1.9133949279785156
officecrawl3_6,26,1,0,26,36.53327941894531,10.533279418945312
officecrawl3_6,26,2,37,-11,-8.723381996154785,2.276618003845215
officecrawl3_7,28,1,0,28,8.890119552612305,19.109880447387695
officecrawl3_7,28,2,9,19,12.602022171020508,6.397977828979492
officecrawl3_7,28,3,22,6,2.734217643737793,3.265782356262207
officecrawl3_7,28,4,25,3,4.502053260803223,1.5020532608032227
officecrawl3_8,19,1,0,19,14.649834632873535,4.350165367126465
officecrawl3_8,19,2,15,4,2.4815821647644043,1.5184178352355957
officecrawl3_9,25,1,0,25,6.020561218261719,18.97943878173828
officecrawl3_9,25,2,6,19,9.63475513458252,9.36524486541748
officecrawl3_9,25,3,16,9,-1.4751739501953125,10.475173950195312
officecrawl3_9,25,4,15,10,-10.623137474060059,20.623138427734375
officecrawl3_9,25,5,4,21,9.050695419311523,11.949304580688477
officecrawl3_9,25,6,13,12,7.618391990661621,4.381608009338379
officecrawl3_9,25,7,21,4,-3.9540936946868896,7.954093933105469
officeroom1_0,27,1,0,27,5.505588054656982,21.49441146850586
officeroom1_0,27,2,6,21,16.54941749572754,4.450582504272461
officeroom1_0,27,3,23,4,14.665813446044922,10.665813446044922
officeroom1_0,27,4,38,-11,7.716795444488525,18.716794967651367
officeroom1_0,27,5,46,-19,-6.33728551864624,12.662714004516602
officeroom1_0,27,6,40,-13,14.356369972229004,27.356369018554688
officeroom1_0,27,7,48,-21,4.408158302307129,25.408157348632812
officeroom1_1,28,1,0,28,16.520273208618164,11.479726791381836
officeroom1_1,28,2,17,11,9.961204528808594,1.0387954711914062
officeroom1_2,29,1,0,29,22.302448272705078,6.697551727294922
officeroom1_2,29,2,22,7,10.157482147216797,3.157482147216797
officeroom1_2,29,3,32,-3,3.814699649810791,6.814699649810791
officeroom1_2,29,4,36,-7,1.6549285650253296,8.654928207397461
officeroom1_2,29,5,38,-9,-9.858671188354492,0.8586711883544922
officeroom1_3,29,1,0,29,26.393205642700195,2.6067943572998047
officeroom1_4,21,1,0,21,21.815868377685547,0.8158683776855469
officeroom1_5,22,1,0,22,6.731542110443115,15.268457412719727
officeroom1_5,22,2,7,15,6.165083885192871,8.834916114807129
officeroom1_5,22,3,13,9,5.041916370391846,3.9580836296081543
officeroom1_5,22,4,18,4,1.6624928712844849,2.3375072479248047
officeroom1_6,22,1,0,22,9.199962615966797,12.800037384033203
officeroom1_6,22,2,9,13,6.340153694152832,6.659846305847168
officeroom1_6,22,3,15,7,5.339023590087891,1.6609764099121094
officeroom1_7,22,1,0,22,-6.496487140655518,28.49648666381836
officeroom1_7,22,2,0,22,-4.380832672119141,26.38083267211914
officeroom1_7,22,3,0,22,3.014292001724243,18.985708236694336
officeroom1_7,22,4,3,19,-3.636535406112671,22.63653564453125
officeroom1_7,22,5,0,22,-8.845989227294922,30.845989227294922
officeroom1_7,22,6,0,22,-3.8932409286499023,25.89324188232422
officeroom1_7,22,7,0,22,1.8511605262756348,20.148839950561523
officeroom1_8,22,1,0,22,13.847421646118164,8.152578353881836
officeroom1_8,22,2,14,8,4.411744117736816,3.5882558822631836
officeroom1_8,22,3,18,4,5.878180503845215,1.8781805038452148
officeroom1_9,27,1,0,27,23.91875457763672,3.0812454223632812
officeroom1_9,27,2,24,3,14.763373374938965,11.763373374938965
officeroom1_9,27,3,39,-12,10.792853355407715,22.79285430908203
officeroom1_9,27,4,48,-21,-11.646288871765137,9.353711128234863
officeroom1_9,27,5,36,-9,-3.092957019805908,5.907042980194092
officeroom1_9,27,6,33,-6,-1.7900334596633911,4.209966659545898
officeroom1_9,27,7,31,-4,6.475735187530518,10.47573471069336
officetrashshadows_1,34,1,4,30,5.3406901359558105,24.65930938720703
officetrashshadows_1,34,2,9,25,6.135919094085693,18.86408042907715
officetrashshadows_1,34,3,15,19,-5.010230541229248,24.010231018066406
officetrashshadows_1,34,4,10,24,1.326873779296875,22.673126220703125
officetrashshadows_1,34,5,11,23,-3.8855748176574707,26.885574340820312
officetrashshadows_1,34,6,7,27,2.766340970993042,24.233659744262695
officetrashshadows_1,34,7,10,24,3.071315050125122,20.92868423461914
officetrashshadows_2,23,1,0,23,6.303541660308838,16.69645881652832
officetrashshadows_2,23,2,6,17,6.045094013214111,10.954906463623047
officetrashshadows_2,23,3,12,11,3.7030322551727295,7.296967506408691
officetrashshadows_2,23,4,16,7,2.1937642097473145,4.8062357902526855
officetrashshadows_2,23,5,18,5,5.06334114074707,0.06334114074707031
officetrashshadows_3,27,1,0,27,37.11118698120117,10.111186981201172
officetrashshadows_3,27,2,37,-10,-7.6815009117126465,2.3184990882873535
officetrashshadows_4,36,1,6,30,23.01752471923828,6.982475280761719
officetrashshadows_4,36,2,29,7,7.477193355560303,0.47719335556030273
officetrashshadows_5,39,1,9,30,10.482202529907227,19.517797470092773
officetrashshadows_5,39,2,19,20,2.1066789627075195,17.893321990966797
officetrashshadows_5,39,3,21,18,4.410501003265381,13.589498519897461
officetrashshadows_5,39,4,25,14,9.195158004760742,4.804841995239258
officetrashshadows_5,39,5,34,5,-2.297201156616211,7.297201156616211
officetrashshadows_5,39,6,32,7,3.0193073749542236,3.9806926250457764
officetrashshadows_5,39,7,35,4,3.8128976821899414,0.1871023178100586
officetrashshadows_6,37,1,7,30,7.547415733337402,22.45258331298828
officetrashshadows_6,37,2,15,22,8.550447463989258,13.449552536010742
officetrashshadows_6,37,3,24,13,6.9100799560546875,6.0899200439453125
officetrashshadows_6,37,4,31,6,2.0775084495544434,3.9224915504455566
officetrashshadows_6,37,5,33,4,0.5967097878456116,3.403290271759033
officetrashshadows_6,37,6,34,3,2.1997766494750977,0.8002233505249023
officetrashshadows_8,25,1,0,25,9.258841514587402,15.741158485412598
officetrashshadows_8,25,2,9,16,4.256872653961182,11.743127822875977
officetrashshadows_8,25,3,13,12,-1.1224511861801147,13.122450828552246
officetrashshadows_8,25,4,12,13,7.346107006072998,5.653892993927002
officetrashshadows_8,25,5,19,6,0.5921101570129395,5.4078898429870605
officetrashshadows_8,25,6,20,5,1.9245377779006958,3.0754623413085938
officetrashshadows_8,25,7,22,3,-2.9815478324890137,5.981547832489014
officetrashshadows_9,27,1,0,27,36.57522964477539,9.57522964477539
officetrashshadows_9,27,2,37,-10,-9.914039611816406,0.08596038818359375
officetrash_0,26,1,0,26,48.34342575073242,22.343425750732422
officetrash_0,26,2,48,-22,-18.38412094116211,3.6158790588378906
officetrash_0,26,3,30,-4,-4.92580509185791,0.9258050918579102
officetrash_1,23,1,0,23,6.686812877655029,16.313186645507812
officetrash_1,23,2,7,16,10.420387268066406,5.579612731933594
officetrash_1,23,3,17,6,6.127721786499023,0.12772178649902344
officetrash_2,25,1,0,25,7.327218532562256,17.672780990600586
officetrash_2,25,2,7,18,9.827576637268066,8.172423362731934
officetrash_2,25,3,17,8,4.356106758117676,3.643893241882324
officetrash_2,25,4,21,4,-1.131461501121521,5.1314616203308105
officetrash_2,25,5,20,5,4.707380294799805,0.2926197052001953
officetrash_4,33,1,3,30,18.046401977539062,11.953598022460938
officetrash_4,33,2,21,12,5.756544589996338,6.243455410003662
officetrash_4,33,3,27,6,4.03805685043335,1.9619431495666504
officetrash_5,32,1,2,30,13.82280445098877,16.177196502685547
officetrash_5,32,2,16,16,16.294477462768555,0.2944774627685547
officetrash_6,24,1,0,24,14.30688762664795,9.69311237335205
officetrash_6,24,2,14,10,4.162704944610596,5.837295055389404
officetrash_6,24,3,18,6,4.506420612335205,1.493579387664795
officetrash_7,31,1,1,30,25.131542205810547,4.868457794189453
officetrash_7,31,2,26,5,3.844381332397461,1.155618667602539
officetrash_8,25,1,0,25,22.478334426879883,2.521665573120117
outdoorsbalcony1_0,24,1,0,24,34.116634368896484,10.116634368896484
outdoorsbalcony1_0,24,2,34,-10,-12.489919662475586,2.489919662475586
outdoorsbalcony1_1,23,1,0,23,27.939472198486328,4.939472198486328
outdoorsbalcony1_1,23,2,28,-5,0.7677667737007141,5.767766952514648
outdoorsbalcony1_1,23,3,29,-6,1.003332257270813,7.003332138061523
outdoorsbalcony1_1,23,4,30,-7,0.9770349860191345,7.977035045623779
outdoorsbalcony1_1,23,5,31,-8,-8.248895645141602,0.24889564514160156
outdoorsbalcony1_2,33,1,3,30,39.450340270996094,9.450340270996094
outdoorsbalcony1_2,33,2,42,-9,9.870414733886719,18.87041473388672
outdoorsbalcony1_2,33,3,48,-15,-2.916905164718628,12.083094596862793
outdoorsbalcony1_2,33,4,45,-12,-7.773395538330078,4.226604461669922
outdoorsbalcony1_2,33,5,37,-4,7.043564796447754,11.043564796447754
outdoorsbalcony1_2,33,6,44,-11,8.51822566986084,19.518226623535156
outdoorsbalcony1_2,33,7,48,-15,-5.041598796844482,9.95840072631836
outdoorsbalcony1_3,44,1,14,30,32.50392150878906,2.5039215087890625
outdoorsbalcony1_4,29,1,0,29,20.18093490600586,8.81906509399414
outdoorsbalcony1_4,29,2,20,9,5.552678108215332,3.447321891784668
outdoorsbalcony1_4,29,3,26,3,0.9243742823600769,2.0756256580352783
outdoorsbalcony1_6,29,1,0,29,31.63323974609375,2.63323974609375
outdoorsbalcony1_9,38,1,8,30,6.325329780578613,23.674671173095703
outdoorsbalcony1_9,38,2,14,24,12.369872093200684,11.630127906799316
outdoorsbalcony1_9,38,3,26,12,7.876452922821045,4.123547077178955
outdoorsbalcony1_9,38,4,34,4,-5.56705379486084,9.56705379486084
outdoorsbalcony1_9,38,5,28,10,8.997549057006836,1.002450942993164
outdoorsbalcony2_0,23,1,0,23,13.536099433898926,9.463900566101074
outdoorsbalcony2_0,23,2,14,9,8.539469718933105,0.46053028106689453
outdoorsbalcony2_1,27,1,0,27,19.540653228759766,7.459346771240234
outdoorsbalcony2_1,27,2,20,7,6.393624782562256,0.6063752174377441
outdoorsbalcony2_2,34,1,4,30,10.185402870178223,19.814598083496094
outdoorsbalcony2_2,34,2,14,20,10.020037651062012,9.979962348937988
outdoorsbalcony2_2,34,3,24,10,6.994734764099121,3.005265235900879
outdoorsbalcony2_2,34,4,31,3,15.527067184448242,12.527067184448242
outdoorsbalcony2_2,34,5,47,-13,-7.235531806945801,5.764468193054199
outdoorsbalcony2_2,34,6,40,-6,-3.5611519813537598,2.4388480186462402
outdoorsbalcony2_4,21,1,0,21,14.545001029968262,6.454998970031738
outdoorsbalcony2_4,21,2,15,6,-3.6220486164093018,9.622048377990723
outdoorsbalcony2_4,21,3,11,10,3.863805055618286,6.136195182800293
outdoorsbalcony2_4,21,4,15,6,3.43369722366333,2.56630277633667
outdoorsbalcony2_5,23,1,0,23,20.46610450744629,2.533895492553711
outdoorsbalcony2_6,26,1,0,26,26.375938415527344,0.37593841552734375
outdoorsbalcony2_7,27,1,0,27,14.907842636108398,12.092157363891602
outdoorsbalcony2_7,27,2,15,12,5.887866497039795,6.112133502960205
outdoorsbalcony2_7,27,3,21,6,5.625024318695068,0.37497568130493164
outdoorsbalcony2_8,24,1,0,24,17.789003372192383,6.210996627807617
outdoorsbalcony2_8,24,2,18,6,16.375036239624023,10.375036239624023
outdoorsbalcony2_8,24,3,34,-10,-13.428257942199707,3.428257942199707
outdoorsbalcony2_8,24,4,21,3,7.974645614624023,4.974645614624023
outdoorsbalcony2_8,24,5,29,-5,-5.890266418457031,0.8902664184570312
outdoorsbalcony2_9,21,1,0,21,9.244668960571289,11.755331039428711
outdoorsbalcony2_9,21,2,9,12,8.594990730285645,3.4050092697143555
outdoorsbalcony2_9,21,3,18,3,1.4711925983428955,1.5288074016571045
outdoorsfossils_3,24,1,0,24,20.739633560180664,3.260366439819336
outdoorsfossils_3,24,2,21,3,2.1454896926879883,0.8545103073120117
outdoorsfossils_5,25,1,0,25,10.761448860168457,14.238551139831543
outdoorsfossils_5,25,2,11,14,1.5568445920944214,12.443155288696289
outdoorsfossils_5,25,3,13,12,1.0590834617614746,10.940916061401367
outdoorsfossils_5,25,4,14,11,1.2333378791809082,9.76666259765625
outdoorsfossils_5,25,5,15,10,-2.178863763809204,12.178863525390625
outdoorsfossils_5,25,6,13,12,1.5164772272109985,10.483522415161133
outdoorsfossils_5,25,7,15,10,-1.720499038696289,11.720499038696289
outdoorsfossils_6,24,1,0,24,16.981761932373047,7.018238067626953
outdoorsfossils_6,24,2,17,7,4.3896331787109375,2.6103668212890625
outdoorsfossils_7,23,1,0,23,12.676257133483887,10.323742866516113
outdoorsfossils_7,23,2,13,10,5.872729301452637,4.127270698547363
outdoorsfossils_7,23,3,19,4,3.98160457611084,0.018395423889160156
outdoorsfossils_8,24,1,0,24,12.09765338897705,11.90234661102295
outdoorsfossils_8,24,2,12,12,7.946301460266113,4.053698539733887
outdoorsfossils_8,24,3,20,4,5.7327046394348145,1.7327046394348145
outdoorsfossils_9,25,1,0,25,17.65243148803711,7.347568511962891
outdoorsfossils_9,25,2,18,7,7.440269470214844,0.44026947021484375
outdoorsplants_0,37,1,7,30,20.424209594726562,9.575790405273438
outdoorsplants_0,37,2,27,10,11.714594841003418,1.714594841003418
outdoorsplants_1,34,1,4,30,20.14527130126953,9.854728698730469
outdoorsplants_1,34,2,24,10,15.28945541381836,5.289455413818359
outdoorsplants_1,34,3,39,-5,16.29652976989746,21.29652976989746
outdoorsplants_1,34,4,48,-14,15.41855525970459,29.418556213378906
outdoorsplants_1,34,5,48,-14,12.69251537322998,26.692516326904297
outdoorsplants_1,34,6,48,-14,11.36696720123291,25.366966247558594
outdoorsplants_1,34,7,48,-14,11.456292152404785,25.45629119873047
outdoorsplants_2,32,1,2,30,-3.4730231761932373,33.4730224609375
outdoorsplants_2,32,2,0,32,10.034773826599121,21.965225219726562
outdoorsplants_2,32,3,10,22,16.426950454711914,5.573049545288086
outdoorsplants_2,32,4,26,6,19.712169647216797,13.712169647216797
outdoorsplants_2,32,5,46,-14,15.263319969177246,29.263320922851562
outdoorsplants_2,32,6,48,-16,13.80009937286377,29.800098419189453
outdoorsplants_2,32,7,48,-16,14.415459632873535,30.41545867919922
outdoorsplants_3,23,1,0,23,25.84455108642578,2.8445510864257812
outdoorsplants_6,25,1,0,25,32.72233581542969,7.7223358154296875
outdoorsplants_6,25,2,33,-8,-11.770624160766602,3.7706241607666016
outdoorsplants_6,25,3,21,4,9.240346908569336,5.240346908569336
outdoorsplants_6,25,4,30,-5,-9.740942001342773,4.740942001342773
outdoorsplants_6,25,5,20,5,7.9290056228637695,2.9290056228637695
outdoorsplants_7,19,1,0,19,16.155916213989258,2.844083786010742
outdoorsplants_8,20,1,0,20,9.39024543762207,10.60975456237793
outdoorsplants_8,20,2,9,11,4.43391752243042,6.56608247756958
outdoorsplants_8,20,3,13,7,1.5474649667739868,5.452535152435303
outdoorsplants_8,20,4,15,5,-3.161749839782715,8.161749839782715
outdoorsplants_8,20,5,12,8,3.505462646484375,4.494537353515625
outdoorsplants_8,20,6,16,4,-0.5286991000175476,4.528698921203613
outdoorsplants_8,20,7,15,5,2.5054757595062256,2.4945242404937744
outdoorsplants_9,23,1,0,23,21.147592544555664,1.852407455444336
photobox1_0,22,1,0,22,15.066093444824219,6.933906555175781
photobox1_0,22,2,15,7,8.144563674926758,1.1445636749267578
photobox1_1,22,1,0,22,22.290159225463867,0.2901592254638672
photobox1_2,22,1,0,22,16.735727310180664,5.264272689819336
photobox1_2,22,2,17,5,2.021108388900757,2.978891611099243
photobox1_3,23,1,0,23,23.065622329711914,0.06562232971191406
photobox1_4,21,1,0,21,20.65497589111328,0.34502410888671875
photobox1_5,22,1,0,22,18.251401901245117,3.748598098754883
photobox1_5,22,2,18,4,-2.451615333557129,6.451615333557129
photobox1_5,22,3,16,6,1.753570318222046,4.246429443359375
photobox1_5,22,4,18,4,-1.52145254611969,5.5214524269104
photobox1_5,22,5,16,6,2.104621171951294,3.895378828048706
photobox1_5,22,6,18,4,-0.2532687485218048,4.253268718719482
photobox1_5,22,7,18,4,1.6711565256118774,2.328843593597412
photobox1_6,23,1,0,23,0.8164259195327759,22.183574676513672
photobox1_6,23,2,1,22,7.301538944244385,14.698461532592773
photobox1_6,23,3,8,15,-7.375250339508057,22.3752498626709
photobox1_6,23,4,1,22,9.656285285949707,12.343714714050293
photobox1_6,23,5,11,12,12.226572036743164,0.22657203674316406
photobox1_7,22,1,0,22,26.100818634033203,4.100818634033203
photobox1_7,22,2,26,-4,-4.204594612121582,0.20459461212158203
photobox1_8,22,1,0,22,12.183430671691895,9.816569328308105
photobox1_8,22,2,12,10,8.602336883544922,1.3976631164550781
photobox1_9,26,1,0,26,28.560073852539062,2.5600738525390625
photobox2_0,23,1,0,23,34.22834014892578,11.228340148925781
photobox2_0,23,2,34,-11,5.176631927490234,16.176631927490234
photobox2_0,23,3,39,-16,-7.7802510261535645,8.219749450683594
photobox2_0,23,4,31,-8,4.876773834228516,12.876773834228516
photobox2_0,23,5,36,-13,0.5460084676742554,13.546008110046387
photobox2_0,23,6,37,-14,1.0941804647445679,15.0941801071167
photobox2_0,23,7,38,-15,-4.881440162658691,10.118559837341309
photobox2_1,23,1,0,23,21.827966690063477,1.1720333099365234
photobox2_2,23,1,0,23,20.949787139892578,2.050212860107422
photobox2_3,23,1,0,23,24.032089233398438,1.0320892333984375
photobox2_4,24,1,0,24,16.556848526000977,7.443151473999023
photobox2_4,24,2,17,7,11.038305282592773,4.038305282592773
photobox2_4,24,3,28,-4,6.174991130828857,10.174991607666016
photobox2_4,24,4,34,-10,-7.2727952003479,2.7272047996520996
photobox2_5,26,1,0,26,12.520488739013672,13.479511260986328
photobox2_5,26,2,13,13,7.933339595794678,5.066660404205322
photobox2_5,26,3,21,5,1.2960871458053589,3.7039127349853516
photobox2_5,26,4,22,4,0.3089282512664795,3.6910717487335205
photobox2_5,26,5,22,4,0.19373819231987,3.8062617778778076
photobox2_5,26,6,22,4,-0.6644842028617859,4.664484024047852
photobox2_5,26,7,21,5,2.2530252933502197,2.7469747066497803
photobox2_6,22,1,0,22,5.981403827667236,16.018596649169922
photobox2_6,22,2,6,16,7.514954566955566,8.485045433044434
photobox2_6,22,3,14,8,2.831038236618042,5.168961524963379
photobox2_6,22,4,17,5,1.1689152717590332,3.831084728240967
photobox2_6,22,5,18,4,0.9022308588027954,3.097769260406494
photobox2_6,22,6,19,3,-1.0986180305480957,4.098618030548096
photobox2_6,22,7,18,4,-0.3858474791049957,4.385847568511963
photobox2_7,22,1,0,22,16.856033325195312,5.1439666748046875
photobox2_7,22,2,17,5,2.9624712467193604,2.0375287532806396
photobox2_8,29,1,0,29,46.0794563293457,17.079456329345703
photobox2_8,29,2,46,-17,-7.616456985473633,9.383543014526367
photobox2_8,29,3,38,-9,1.7621455192565918,10.76214599609375
photobox2_8,29,4,40,-11,-9.036617279052734,1.9633827209472656
photobox2_9,23,1,0,23,23.01417350769043,0.014173507690429688
randomsurplus_0,19,1,0,19,6.824076175689697,12.175924301147461
randomsurplus_0,19,2,7,12,-6.187935829162598,18.18793487548828
randomsurplus_0,19,3,1,18,8.851848602294922,9.148151397705078
randomsurplus_0,19,4,10,9,-7.167619705200195,16.167619705200195
randomsurplus_0,19,5,3,16,5.761656284332275,10.238344192504883
randomsurplus_0,19,6,9,10,-4.934829235076904,14.934829711914062
randomsurplus_0,19,7,4,15,2.7054762840270996,12.294523239135742
randomsurplus_1,41,1,11,30,28.724178314208984,1.2758216857910156
randomsurplus_2,20,1,0,20,13.37093734741211,6.629062652587891
randomsurplus_2,20,2,13,7,5.048421859741211,1.951578140258789
randomsurplus_3,29,1,0,29,22.36017417907715,6.639825820922852
randomsurplus_3,29,2,22,7,7.974620342254639,0.9746203422546387
randomsurplus_4,29,1,0,29,38.525634765625,9.525634765625
randomsurplus_4,29,2,39,-10,-6.547955513000488,3.4520444869995117
randomsurplus_4,29,3,32,-3,1.7095228433609009,4.709522724151611
randomsurplus_4,29,4,34,-5,-1.777335286140442,3.2226648330688477
randomsurplus_4,29,5,32,-3,3.152538299560547,6.152538299560547
randomsurplus_4,29,6,35,-6,-0.44414782524108887,5.555851936340332
randomsurplus_4,29,7,35,-6,-1.3451858758926392,4.65481424331665
randomsurplus_5,21,1,0,21,21.39336395263672,0.39336395263671875
randomsurplus_6,22,1,0,22,6.44724702835083,15.552753448486328
randomsurplus_6,22,2,6,16,7.387624263763428,8.612375259399414
randomsurplus_6,22,3,13,9,6.863948822021484,2.1360511779785156
randomsurplus_7,22,1,0,22,23.02267837524414,1.0226783752441406
randomsurplus_8,28,1,0,28,4.068983554840088,23.93101692199707
randomsurplus_8,28,2,4,24,13.153416633605957,10.846583366394043
randomsurplus_8,28,3,17,11,7.734764099121094,3.2652359008789062
randomsurplus_8,28,4,25,3,6.371628761291504,3.371628761291504
randomsurplus_8,28,5,31,-3,6.9861907958984375,9.986190795898438
randomsurplus_8,28,6,38,-10,-3.327192783355713,6.672807216644287
randomsurplus_8,28,7,35,-7,14.876691818237305,21.876691818237305
randomsurplus_9,28,1,0,28,-10.804777145385742,38.804779052734375
randomsurplus_9,28,2,0,28,-22.325618743896484,50.325618743896484
randomsurplus_9,28,3,0,28,11.021141052246094,16.978858947753906
randomsurplus_9,28,4,11,17,8.38997745513916,8.61002254486084
randomsurplus_9,28,5,19,9,1.0756984949111938,7.924301624298096
randomsurplus_9,28,6,20,8,2.128643751144409,5.871356010437012
randomsurplus_9,28,7,22,6,1.5594183206558228,4.440581798553467
secondfloorbalcony_0,32,1,2,30,18.119382858276367,11.880617141723633
secondfloorbalcony_0,32,2,20,12,6.577602386474609,5.422397613525391
secondfloorbalcony_0,32,3,27,5,8.536404609680176,3.536404609680176
secondfloorbalcony_0,32,4,36,-4,-5.209160804748535,1.2091608047485352
secondfloorbalcony_1,34,1,4,30,42.2425651550293,12.242565155029297
secondfloorbalcony_1,34,2,46,-12,-13.98017406463623,1.9801740646362305
secondfloorbalcony_3,20,1,0,20,5.636098861694336,14.363901138305664
secondfloorbalcony_3,20,2,6,14,2.546820640563965,11.453179359436035
secondfloorbalcony_3,20,3,9,11,2.303668737411499,8.696331024169922
secondfloorbalcony_3,20,4,11,9,0.41748443245887756,8.582515716552734
secondfloorbalcony_3,20,5,11,9,1.4391026496887207,7.560897350311279
secondfloorbalcony_3,20,6,12,8,0.6642822027206421,7.335717678070068
secondfloorbalcony_3,20,7,13,7,-3.337405204772949,10.33740520477295
secondfloorbalcony_4,23,1,0,23,10.311233520507812,12.688766479492188
secondfloorbalcony_4,23,2,10,13,-7.262170791625977,20.262170791625977
secondfloorbalcony_4,23,3,3,20,-10.571666717529297,30.571666717529297
secondfloorbalcony_4,23,4,0,23,-11.184844970703125,34.184844970703125
secondfloorbalcony_4,23,5,0,23,17.45180320739746,5.548196792602539
secondfloorbalcony_4,23,6,17,6,-17.99266815185547,23.99266815185547
secondfloorbalcony_4,23,7,0,23,25.506656646728516,2.5066566467285156
secondfloorbalcony_6,23,1,0,23,24.525375366210938,1.5253753662109375
secondfloorbalcony_7,19,1,0,19,10.821769714355469,8.178230285644531
secondfloorbalcony_7,19,2,11,8,2.5414183139801025,5.458581924438477
secondfloorbalcony_7,19,3,14,5,2.922292947769165,2.077707052230835
secondfloorbalcony_8,19,1,0,19,13.29012393951416,5.70987606048584
secondfloorbalcony_8,19,2,13,6,-1.7837131023406982,7.783713340759277
secondfloorbalcony_8,19,3,11,8,2.819378137588501,5.180622100830078
secondfloorbalcony_8,19,4,14,5,-4.090420246124268,9.09041976928711
secondfloorbalcony_8,19,5,10,9,2.2180380821228027,6.781961917877197
secondfloorbalcony_8,19,6,12,7,0.6642751693725586,6.335724830627441
secondfloorbalcony_8,19,7,13,6,-3.5657219886779785,9.56572151184082
secondfloorbalcony_9,21,1,0,21,14.904034614562988,6.095965385437012
secondfloorbalcony_9,21,2,15,6,5.50734281539917,0.4926571846008301
