filename,CorrectPosition,focus_time,index,label,pred,loss
home1_0,31,1,48,-17,-14.77679443359375,2.22320556640625
home1_1,23,1,43,-20,-8.29981517791748,11.70018482208252
home1_1,23,2,35,-12,-12.671977043151855,0.6719770431518555
home1_2,44,1,48,-4,-11.566105842590332,7.566105842590332
home1_2,44,2,36,8,12.18203067779541,4.18203067779541
home1_2,44,3,48,-4,-4.222912311553955,0.22291231155395508
home1_3,31,1,48,-17,-10.704591751098633,6.295408248901367
home1_3,31,2,37,-6,-3.8273608684539795,2.1726391315460205
home1_4,47,1,48,-1,-14.252106666564941,13.252106666564941
home1_4,47,2,34,13,8.056221008300781,4.943778991699219
home1_4,47,3,42,5,1.632430076599121,3.367569923400879
home1_4,47,4,44,3,0.26758503913879395,2.732414960861206
home1_6,37,1,48,-11,-23.005321502685547,12.005321502685547
home1_6,37,2,25,12,7.79854679107666,4.20145320892334
home1_6,37,3,33,4,4.177849292755127,0.17784929275512695
home1_8,32,1,48,-16,-30.302976608276367,14.302976608276367
home1_8,32,2,18,14,20.28753662109375,6.28753662109375
home1_8,32,3,38,-6,-11.23925495147705,5.239254951477051
home1_8,32,4,27,5,7.497082710266113,2.4970827102661133
home1_9,27,1,47,-20,-24.136234283447266,4.136234283447266
home1_9,27,2,23,4,5.061825275421143,1.0618252754211426
home2_0,44,1,48,-4,-11.561299324035645,7.5612993240356445
home2_0,44,2,36,8,8.016109466552734,0.016109466552734375
home2_2,37,1,48,-11,-3.028883218765259,7.97111701965332
home2_2,37,2,45,-8,-8.836387634277344,0.8363876342773438
home2_3,32,1,48,-16,-4.226891994476318,11.773107528686523
home2_3,32,2,44,-12,-4.57277774810791,7.42722225189209
home2_3,32,3,39,-7,-5.185598373413086,1.814401626586914
home2_4,37,1,48,-11,19.20102882385254,30.20102882385254
home2_4,37,2,48,-11,1.2114461660385132,12.211445808410645
home2_4,37,3,48,-11,-0.4937947392463684,10.506205558776855
home2_4,37,4,48,-11,6.0804548263549805,17.080455780029297
home2_4,37,5,48,-11,2.3940494060516357,13.394049644470215
home2_4,37,6,48,-11,4.793158531188965,15.793158531188965
home2_4,37,7,48,-11,-5.412611961364746,5.587388038635254
home2_5,31,1,48,-17,-12.80977725982666,4.19022274017334
home2_5,31,2,35,-4,-2.408534526824951,1.5914654731750488
home2_6,25,1,45,-20,-3.7825138568878174,16.217485427856445
home2_6,25,2,41,-16,-8.550354957580566,7.449645042419434
home2_6,25,3,32,-7,-8.857891082763672,1.8578910827636719
home2_9,30,1,48,-18,-9.682178497314453,8.317821502685547
home2_9,30,2,38,-8,-7.6534247398376465,0.3465752601623535
microkitchen1_0,21,1,41,-20,-15.3706636428833,4.629336357116699
microkitchen1_0,21,2,26,-5,-9.027894020080566,4.027894020080566
microkitchen1_0,21,3,17,4,1.8683056831359863,2.1316943168640137
microkitchen1_1,21,1,41,-20,-17.072031021118164,2.927968978881836
microkitchen1_2,21,1,41,-20,-19.75167465209961,0.24832534790039062
microkitchen1_3,24,1,44,-20,-17.944944381713867,2.055055618286133
microkitchen1_4,25,1,45,-20,-14.974370002746582,5.025629997253418
microkitchen1_4,25,2,30,-5,-2.363264322280884,2.636735677719116
microkitchen1_5,25,1,45,-20,-17.10160255432129,2.898397445678711
microkitchen1_6,27,1,47,-20,-13.721414566040039,6.278585433959961
microkitchen1_6,27,2,33,-6,-3.7629871368408203,2.2370128631591797
microkitchen1_7,24,1,44,-20,-17.513442993164062,2.4865570068359375
microkitchen1_8,28,1,48,-20,-14.940874099731445,5.059125900268555
microkitchen1_8,28,2,33,-5,-6.2514166831970215,1.2514166831970215
microkitchen1_9,20,1,40,-20,-20.419649124145508,0.4196491241455078
pillowroom1_6,36,1,48,-12,-14.997689247131348,2.9976892471313477
pillowroom1_8,34,1,48,-14,-18.399106979370117,4.399106979370117
pillowroom1_8,34,2,30,4,11.895030975341797,7.895030975341797
pillowroom1_8,34,3,42,-8,-8.07404613494873,0.07404613494873047
pillowroom1_9,24,1,44,-20,-18.613651275634766,1.3863487243652344
secondfloorgames_0,20,1,40,-20,-16.691375732421875,3.308624267578125
secondfloorgames_0,20,2,23,-3,-9.514863014221191,6.514863014221191
secondfloorgames_0,20,3,13,7,-8.36363697052002,15.36363697052002
secondfloorgames_0,20,4,5,15,16.607501983642578,1.6075019836425781
secondfloorgames_1,21,1,41,-20,-15.14500617980957,4.85499382019043
secondfloorgames_1,21,2,26,-5,-3.4830148220062256,1.5169851779937744
secondfloorgames_2,23,1,43,-20,-17.670812606811523,2.3291873931884766
secondfloorgames_3,26,1,46,-20,-17.412628173828125,2.587371826171875
secondfloorgames_4,34,1,48,-14,-19.153263092041016,5.153263092041016
secondfloorgames_4,34,2,29,5,4.4626078605651855,0.5373921394348145
secondfloorgames_5,27,1,47,-20,-16.6966552734375,3.3033447265625
secondfloorgames_5,27,2,30,-3,-7.545128345489502,4.545128345489502
secondfloorgames_5,27,3,22,5,5.146368026733398,0.14636802673339844
secondfloorgames_6,25,1,45,-20,-18.190771102905273,1.8092288970947266
secondfloorgames_7,25,1,45,-20,-10.783329010009766,9.216670989990234
secondfloorgames_7,25,2,34,-9,-8.25461196899414,0.7453880310058594
secondfloorgames_8,23,1,43,-20,-13.566967964172363,6.433032035827637
secondfloorgames_8,23,2,29,-6,-6.749821186065674,0.7498211860656738
apt1_0,26,1,46,-20,-7.252458572387695,12.747541427612305
apt1_0,26,2,39,-13,-7.850135326385498,5.149864673614502
apt1_0,26,3,31,-5,-0.4174118638038635,4.582588195800781
apt1_0,26,4,31,-5,-17.585758209228516,12.585758209228516
apt1_0,26,5,13,13,10.858400344848633,2.141599655151367
apt1_1,22,1,42,-20,-13.514598846435547,6.485401153564453
apt1_1,22,2,28,-6,-11.862297058105469,5.862297058105469
apt1_1,22,3,16,6,5.883251667022705,0.11674833297729492
apt1_2,24,1,44,-20,-22.673860549926758,2.673860549926758
apt1_3,26,1,46,-20,-8.787153244018555,11.212846755981445
apt1_3,26,2,37,-11,-15.763182640075684,4.763182640075684
apt1_3,26,3,21,5,1.4948346614837646,3.5051653385162354
apt1_3,26,4,22,4,-0.44855746626853943,4.448557376861572
apt1_3,26,5,22,4,-4.598661422729492,8.598661422729492
apt1_3,26,6,17,9,9.537031173706055,0.5370311737060547
apt1_4,23,1,43,-20,-12.347140312194824,7.652859687805176
apt1_4,23,2,31,-8,-10.957249641418457,2.957249641418457
apt1_5,22,1,42,-20,-5.196551322937012,14.803448677062988
apt1_5,22,2,37,-15,-9.317153930664062,5.6828460693359375
apt1_5,22,3,28,-6,-4.735879421234131,1.2641205787658691
apt1_6,23,1,43,-20,-25.837692260742188,5.8376922607421875
apt1_6,23,2,17,6,3.8888745307922363,2.1111254692077637
apt1_7,27,1,47,-20,-19.609251022338867,0.3907489776611328
apt1_8,31,1,48,-17,-14.398805618286133,2.601194381713867
apt1_9,26,1,46,-20,-18.15648651123047,1.8435134887695312
apt2_0,36,1,48,-12,-9.923089027404785,2.076910972595215
apt2_1,24,1,44,-20,-16.01338768005371,3.986612319946289
apt2_1,24,2,28,-4,-5.973456859588623,1.973456859588623
apt2_2,28,1,48,-20,-14.92306137084961,5.076938629150391
apt2_2,28,2,33,-5,-2.1819074153900146,2.8180925846099854
apt2_3,41,1,48,-7,-7.734535217285156,0.7345352172851562
apt2_4,24,1,44,-20,-20.38855743408203,0.38855743408203125
apt2_5,26,1,46,-20,-11.170880317687988,8.829119682312012
apt2_5,26,2,35,-9,-6.869104862213135,2.1308951377868652
apt2_6,26,1,46,-20,-28.126649856567383,8.126649856567383
apt2_6,26,2,18,8,13.316329002380371,5.316329002380371
apt2_6,26,3,31,-5,-10.6364164352417,5.636416435241699
apt2_6,26,4,20,6,6.454794406890869,0.45479440689086914
apt2_7,32,1,48,-16,-7.439653396606445,8.560346603393555
apt2_7,32,2,41,-9,-5.998295307159424,3.001704692840576
apt2_7,32,3,35,-3,-5.680022716522217,2.680022716522217
apt2_8,37,1,48,-11,-11.51101016998291,0.5110101699829102
apt2_9,24,1,44,-20,-10.321892738342285,9.678107261657715
apt2_9,24,2,34,-10,-9.573949813842773,0.42605018615722656
books_0,25,1,45,-20,-20.115949630737305,0.11594963073730469
books_1,25,1,45,-20,-23.421266555786133,3.421266555786133
books_1,25,2,22,3,4.6836838722229,1.6836838722229004
books_2,21,1,41,-20,-19.05858039855957,0.9414196014404297
books_3,22,1,42,-20,-18.177932739257812,1.8220672607421875
books_4,24,1,44,-20,-11.402099609375,8.597900390625
books_4,24,2,33,-9,-9.169638633728027,0.16963863372802734
books_5,21,1,41,-20,-14.844612121582031,5.155387878417969
books_5,21,2,26,-5,-7.911895751953125,2.911895751953125
books_6,20,1,40,-20,-22.446413040161133,2.446413040161133
books_7,25,1,45,-20,-1.353646993637085,18.646352767944336
books_7,25,2,44,-19,-15.34325885772705,3.656741142272949
books_7,25,3,29,-4,-6.783302307128906,2.7833023071289062
books_8,24,1,44,-20,-21.219472885131836,1.219472885131836
books_9,33,1,48,-15,-9.872532844543457,5.127467155456543
books_9,33,2,38,-5,-7.95603609085083,2.95603609085083
bottles_0,22,1,42,-20,-17.388349533081055,2.6116504669189453
bottles_1,22,1,42,-20,-7.770149230957031,12.229850769042969
bottles_1,22,2,34,-12,-15.289101600646973,3.2891016006469727
bottles_1,22,3,19,3,5.033689975738525,2.0336899757385254
bottles_2,24,1,44,-20,-23.2424373626709,3.2424373626708984
bottles_2,24,2,21,3,5.025717735290527,2.0257177352905273
bottles_3,44,1,48,-4,-2.9839987754821777,1.0160012245178223
bottles_4,26,1,46,-20,-3.15743088722229,16.84256935119629
bottles_4,26,2,43,-17,-10.494555473327637,6.505444526672363
bottles_4,26,3,33,-7,-14.132752418518066,7.132752418518066
bottles_4,26,4,19,7,9.02114486694336,2.0211448669433594
bottles_5,26,1,46,-20,-12.173903465270996,7.826096534729004
bottles_5,26,2,34,-8,-6.791861534118652,1.2081384658813477
bottles_6,44,1,48,-4,-3.301642656326294,0.698357343673706
bottles_7,48,1,48,0,-3.477080821990967,3.477080821990967
bottles_7,48,2,45,3,6.738500595092773,3.7385005950927734
bottles_7,48,3,48,0,-4.426482677459717,4.426482677459717
bottles_7,48,4,44,4,0.4707304537296295,3.5292694568634033
bottles_7,48,5,44,4,2.5619890689849854,1.4380109310150146
bottles_8,30,1,48,-18,-13.594481468200684,4.405518531799316
bottles_8,30,2,34,-4,-0.5620719790458679,3.4379279613494873
bottles_8,30,3,33,-3,-6.931177616119385,3.9311776161193848
bottles_8,30,4,26,4,4.315667152404785,0.31566715240478516
campusoutdoors1_0,21,1,41,-20,-12.961029052734375,7.038970947265625
campusoutdoors1_0,21,2,28,-7,-11.77450180053711,4.774501800537109
campusoutdoors1_0,21,3,16,5,2.203824043273926,2.796175956726074
campusoutdoors1_1,20,1,40,-20,-19.336633682250977,0.6633663177490234
campusoutdoors1_2,21,1,41,-20,-13.44847297668457,6.55152702331543
campusoutdoors1_2,21,2,28,-7,-12.359352111816406,5.359352111816406
campusoutdoors1_2,21,3,16,5,4.452877044677734,0.5471229553222656
campusoutdoors1_3,20,1,40,-20,-19.16446304321289,0.8355369567871094
campusoutdoors1_4,23,1,43,-20,-13.191665649414062,6.8083343505859375
campusoutdoors1_4,23,2,30,-7,-9.832558631896973,2.8325586318969727
campusoutdoors1_5,23,1,43,-20,-9.088314056396484,10.911685943603516
campusoutdoors1_5,23,2,34,-11,-15.859023094177246,4.859023094177246
campusoutdoors1_5,23,3,18,5,4.690982341766357,0.3090176582336426
campusoutdoors1_6,22,1,42,-20,-9.66274356842041,10.33725643157959
campusoutdoors1_6,22,2,32,-10,-14.38444995880127,4.3844499588012695
campusoutdoors1_6,22,3,18,4,5.664568901062012,1.6645689010620117
campusoutdoors1_8,19,1,39,-20,-16.85824203491211,3.1417579650878906
campusoutdoors1_8,19,2,22,-3,-5.5758867263793945,2.5758867263793945
campusoutdoors1_9,19,1,39,-20,-10.426155090332031,9.573844909667969
campusoutdoors1_9,19,2,29,-10,-0.5229844450950623,9.477015495300293
campusoutdoors1_9,19,3,28,-9,-10.951539039611816,1.9515390396118164
campusoutdoors2_0,20,1,40,-20,-15.423566818237305,4.576433181762695
campusoutdoors2_0,20,2,25,-5,-5.981342315673828,0.9813423156738281
campusoutdoors2_1,44,1,48,-4,-1.175115942955017,2.8248839378356934
campusoutdoors2_3,28,1,48,-20,-18.28562355041504,1.714376449584961
campusoutdoors2_4,30,1,48,-18,-13.95700740814209,4.04299259185791
campusoutdoors2_4,30,2,34,-4,-7.840836524963379,3.840836524963379
campusoutdoors2_4,30,3,26,4,4.156081199645996,0.1560811996459961
campusoutdoors2_5,29,1,48,-19,-13.88643741607666,5.11356258392334
campusoutdoors2_5,29,2,34,-5,-11.393998146057129,6.393998146057129
campusoutdoors2_5,29,3,23,6,7.7311601638793945,1.7311601638793945
campusoutdoors2_6,22,1,42,-20,-15.630867004394531,4.369132995605469
campusoutdoors2_6,22,2,26,-4,-9.458093643188477,5.458093643188477
campusoutdoors2_6,22,3,17,5,3.8238892555236816,1.1761107444763184
campusoutdoors2_7,23,1,43,-20,-14.634079933166504,5.365920066833496
campusoutdoors2_7,23,2,28,-5,-4.719232082366943,0.28076791763305664
campusoutdoors2_8,22,1,42,-20,-19.017112731933594,0.9828872680664062
campusoutdoors2_9,24,1,44,-20,-16.31404685974121,3.685953140258789
campusoutdoors2_9,24,2,28,-4,-10.610747337341309,6.610747337341309
campusoutdoors2_9,24,3,17,7,5.142547607421875,1.857452392578125
fakeplants_0,23,1,43,-20,-12.682821273803711,7.317178726196289
fakeplants_0,23,2,30,-7,-9.05886459350586,2.0588645935058594
fakeplants_1,22,1,42,-20,-13.874085426330566,6.125914573669434
fakeplants_1,22,2,28,-6,-1.062941074371338,4.937058925628662
fakeplants_1,22,3,27,-5,-3.4617958068847656,1.5382041931152344
fakeplants_2,21,1,41,-20,-12.817973136901855,7.1820268630981445
fakeplants_2,21,2,28,-7,-6.248477458953857,0.7515225410461426
fakeplants_3,30,1,48,-18,-16.426931381225586,1.573068618774414
fakeplants_4,25,1,45,-20,4.278413772583008,24.278413772583008
fakeplants_4,25,2,48,-23,-15.935723304748535,7.064276695251465
fakeplants_4,25,3,32,-7,-9.36972427368164,2.3697242736816406
fakeplants_5,21,1,41,-20,-14.889500617980957,5.110499382019043
fakeplants_5,21,2,26,-5,-2.8822710514068604,2.1177289485931396
fakeplants_6,21,1,41,-20,-17.553205490112305,2.4467945098876953
fakeplants_7,23,1,43,-20,-19.527799606323242,0.4722003936767578
fakeplants_8,22,1,42,-20,-20.239139556884766,0.23913955688476562
fakeplants_9,21,1,41,-20,-14.554876327514648,5.445123672485352
fakeplants_9,21,2,26,-5,2.303708791732788,7.303709030151367
fakeplants_9,21,3,28,-7,-6.63419246673584,0.36580753326416016
garage2_0,22,1,42,-20,-20.06934356689453,0.06934356689453125
garage2_1,27,1,47,-20,-22.423059463500977,2.4230594635009766
garage2_2,31,1,48,-17,-17.47556495666504,0.47556495666503906
garage2_3,43,1,48,-5,-0.5663952231407166,4.433604717254639
garage2_3,43,2,47,-4,-0.9035733342170715,3.0964267253875732
garage2_3,43,3,46,-3,8.542031288146973,11.542031288146973
garage2_3,43,4,48,-5,11.38463306427002,16.384632110595703
garage2_3,43,5,48,-5,-7.454658508300781,2.4546585083007812
garage2_4,29,1,48,-19,-24.876197814941406,5.876197814941406
garage2_4,29,2,23,6,8.404112815856934,2.4041128158569336
garage2_6,26,1,46,-20,-22.745038986206055,2.7450389862060547
garage2_7,21,1,41,-20,-18.648244857788086,1.351755142211914
garage2_8,22,1,42,-20,-10.325368881225586,9.674631118774414
garage2_8,22,2,32,-10,-9.078171730041504,0.9218282699584961
garage2_9,27,1,47,-20,-4.003927707672119,15.996072769165039
garage2_9,27,2,43,-16,-9.737815856933594,6.262184143066406
garage2_9,27,3,33,-6,5.523823261260986,11.523822784423828
garage2_9,27,4,39,-12,-1.6292575597763062,10.370742797851562
garage2_9,27,5,37,-10,-11.165820121765137,1.1658201217651367
garage_0,30,1,48,-18,-12.403731346130371,5.596268653869629
garage_0,30,2,36,-6,-1.9410970211029053,4.058902740478516
garage_0,30,3,34,-4,-3.5767955780029297,0.4232044219970703
garage_3,21,1,41,-20,-13.844812393188477,6.155187606811523
garage_3,21,2,27,-6,-10.421880722045898,4.421880722045898
garage_3,21,3,17,4,-6.611019134521484,10.611019134521484
garage_3,21,4,10,11,8.549129486083984,2.4508705139160156
garage_6,28,1,48,-20,-18.74468231201172,1.2553176879882812
garage_7,23,1,43,-20,-14.469679832458496,5.530320167541504
garage_7,23,2,29,-6,-5.316015243530273,0.6839847564697266
garage_8,40,1,48,-8,-14.17538833618164,6.175388336181641
garage_8,40,2,34,6,5.250194549560547,0.7498054504394531
garage_9,20,1,40,-20,-21.392919540405273,1.3929195404052734
hallway1_0,29,1,48,-19,-19.07366180419922,0.07366180419921875
hallway1_2,34,1,48,-14,-7.681304454803467,6.318695545196533
hallway1_2,34,2,40,-6,-1.1852167844772339,4.814783096313477
hallway1_2,34,3,39,-5,-1.4119877815246582,3.588012218475342
hallway1_2,34,4,38,-4,0.854368269443512,4.854368209838867
hallway1_2,34,5,39,-5,-1.8328937292099,3.1671061515808105
hallway1_2,34,6,37,-3,-1.0156327486038208,1.9843672513961792
hallway1_3,31,1,48,-17,-6.911712169647217,10.088287353515625
hallway1_3,31,2,41,-10,-9.046464920043945,0.9535350799560547
hallway1_4,30,1,48,-18,-13.776453018188477,4.223546981811523
hallway1_4,30,2,34,-4,-5.141500473022461,1.141500473022461
hallway1_5,22,1,42,-20,-19.00267791748047,0.9973220825195312
hallway1_6,27,1,47,-20,-8.172018051147461,11.827981948852539
hallway1_6,27,2,39,-12,-13.367850303649902,1.3678503036499023
hallway1_7,41,1,48,-7,-3.1991794109344482,3.8008205890655518
hallway1_7,41,2,45,-4,-4.257991790771484,0.2579917907714844
hallway2_0,32,1,48,-16,-9.861721992492676,6.138278007507324
hallway2_0,32,2,38,-6,-7.412570953369141,1.4125709533691406
hallway2_2,27,1,47,-20,-13.55825138092041,6.44174861907959
hallway2_2,27,2,33,-6,-6.019660472869873,0.019660472869873047
meetingroom1_7,19,1,39,-20,5.333048343658447,25.33304786682129
meetingroom1_7,19,2,44,-25,-5.882137775421143,19.117862701416016
meetingroom1_7,19,3,38,-19,-8.215723991394043,10.784276008605957
meetingroom1_7,19,4,30,-11,-5.100482940673828,5.899517059326172
meetingroom1_7,19,5,25,-6,10.539387702941895,16.539386749267578
meetingroom1_7,19,6,36,-17,-3.063483238220215,13.936516761779785
meetingroom1_7,19,7,33,-14,-8.844765663146973,5.155234336853027
meetingroom1_8,21,1,41,-20,-21.525997161865234,1.5259971618652344
meetingroom1_9,23,1,43,-20,-16.254207611083984,3.7457923889160156
meetingroom1_9,23,2,27,-4,7.7904791831970215,11.79047966003418
meetingroom1_9,23,3,35,-12,-11.977498054504395,0.02250194549560547
meetingroom2_0,27,1,47,-20,-14.04163932800293,5.95836067199707
meetingroom2_0,27,2,33,-6,2.962536334991455,8.962535858154297
meetingroom2_0,27,3,36,-9,-0.7480761408805847,8.251923561096191
meetingroom2_0,27,4,35,-8,-11.581499099731445,3.5814990997314453
meetingroom2_0,27,5,23,4,2.001279592514038,1.998720407485962
meetingroom2_1,23,1,43,-20,-2.9130654335021973,17.08693504333496
meetingroom2_1,23,2,40,-17,2.1557321548461914,19.155731201171875
meetingroom2_1,23,3,42,-19,-3.2079856395721436,15.792014122009277
meetingroom2_1,23,4,39,-16,-0.3615216910839081,15.63847827911377
meetingroom2_1,23,5,39,-16,-10.21254825592041,5.78745174407959
meetingroom2_1,23,6,29,-6,-7.3558735847473145,1.3558735847473145
meetingroom2_2,23,1,43,-20,-17.12958335876465,2.8704166412353516
meetingroom2_3,27,1,47,-20,-18.027080535888672,1.9729194641113281
meetingroom2_4,21,1,41,-20,4.324003219604492,24.324003219604492
meetingroom2_4,21,2,45,-24,-12.679898262023926,11.320101737976074
meetingroom2_4,21,3,32,-11,-2.51342511177063,8.48657512664795
meetingroom2_4,21,4,29,-8,-7.810025215148926,0.18997478485107422
meetingroom2_5,23,1,43,-20,-7.898046493530273,12.101953506469727
meetingroom2_5,23,2,35,-12,-5.444477558135986,6.555522441864014
meetingroom2_5,23,3,30,-7,-15.516555786132812,8.516555786132812
meetingroom2_5,23,4,14,9,11.920568466186523,2.9205684661865234
meetingroom2_6,25,1,45,-20,-11.568117141723633,8.431882858276367
meetingroom2_6,25,2,33,-8,-8.038283348083496,0.038283348083496094
meetingroom2_7,27,1,47,-20,-17.261993408203125,2.738006591796875
meetingroom2_8,27,1,47,-20,-19.132471084594727,0.8675289154052734
meetingroom2_9,28,1,48,-20,-14.842804908752441,5.157195091247559
meetingroom2_9,28,2,33,-5,2.2160964012145996,7.2160964012146
meetingroom2_9,28,3,35,-7,-8.82409381866455,1.8240938186645508
officecrawl1_0,26,1,46,-20,-12.205734252929688,7.7942657470703125
officecrawl1_0,26,2,34,-8,-10.377799034118652,2.3777990341186523
officecrawl1_1,33,1,48,-15,-13.155851364135742,1.8441486358642578
officecrawl1_2,32,1,48,-16,-11.774164199829102,4.225835800170898
officecrawl1_2,32,2,36,-4,-3.3000686168670654,0.6999313831329346
officecrawl1_3,26,1,46,-20,-13.748446464538574,6.251553535461426
officecrawl1_3,26,2,32,-6,-12.255532264709473,6.255532264709473
officecrawl1_3,26,3,20,6,10.88486385345459,4.88486385345459
officecrawl1_3,26,4,31,-5,-6.648346900939941,1.6483469009399414
officecrawl1_4,38,1,48,-10,-9.236210823059082,0.763789176940918
officecrawl1_5,23,1,43,-20,-12.056713104248047,7.943286895751953
officecrawl1_5,23,2,31,-8,-12.144011497497559,4.144011497497559
officecrawl1_5,23,3,19,4,7.3425822257995605,3.3425822257995605
officecrawl1_5,23,4,26,-3,-2.925877094268799,0.07412290573120117
officecrawl1_6,29,1,48,-19,21.545976638793945,40.54597473144531
officecrawl1_6,29,2,48,-19,-13.006251335144043,5.993748664855957
officecrawl1_6,29,3,35,-6,-7.178542613983154,1.1785426139831543
officecrawl1_7,32,1,48,-16,-22.525102615356445,6.525102615356445
officecrawl1_7,32,2,25,7,3.985273599624634,3.014726400375366
officecrawl1_7,32,3,29,3,-1.6903367042541504,4.69033670425415
officecrawl1_7,32,4,27,5,0.39598047733306885,4.604019641876221
officecrawl1_7,32,5,27,5,4.219486236572266,0.7805137634277344
officecrawl1_8,34,1,48,-14,-16.16639518737793,2.1663951873779297
officecrawl1_9,40,1,48,-8,-5.23636531829834,2.76363468170166
officecrawl2_0,29,1,48,-19,-10.622369766235352,8.377630233764648
officecrawl2_0,29,2,37,-8,-4.903087615966797,3.096912384033203
officecrawl2_0,29,3,32,-3,-7.4535346031188965,4.4535346031188965
officecrawl2_0,29,4,25,4,0.5442063212394714,3.455793619155884
officecrawl2_0,29,5,26,3,7.2595038414001465,4.2595038414001465
officecrawl2_0,29,6,33,-4,-10.066865921020508,6.066865921020508
officecrawl2_0,29,7,23,6,2.707277774810791,3.292722225189209
officecrawl2_1,22,1,42,-20,-3.520811080932617,16.479188919067383
officecrawl2_1,22,2,38,-16,-14.088859558105469,1.9111404418945312
officecrawl2_2,45,1,48,-3,-0.4749354422092438,2.525064468383789
officecrawl2_3,41,1,48,-7,-5.191359519958496,1.808640480041504
officecrawl2_4,27,1,47,-20,-9.042086601257324,10.957913398742676
officecrawl2_4,27,2,38,-11,-11.6275634765625,0.6275634765625
officecrawl2_6,26,1,46,-20,-8.707942962646484,11.292057037353516
officecrawl2_6,26,2,37,-11,-7.081753730773926,3.918246269226074
officecrawl2_6,26,3,30,-4,-8.337179183959961,4.337179183959961
officecrawl2_6,26,4,22,4,2.4477322101593018,1.5522677898406982
officecrawl2_7,29,1,48,-19,-18.089189529418945,0.9108104705810547
officecrawl2_8,23,1,43,-20,-22.48180389404297,2.4818038940429688
officecrawl2_9,44,1,48,-4,-5.043781280517578,1.0437812805175781
officecrawl3_1,26,1,46,-20,-14.16141128540039,5.838588714599609
officecrawl3_1,26,2,32,-6,-6.009396553039551,0.009396553039550781
officecrawl3_2,24,1,44,-20,-17.08924674987793,2.9107532501220703
officecrawl3_3,38,1,48,-10,-15.58403491973877,5.5840349197387695
officecrawl3_3,38,2,32,6,7.019837856292725,1.0198378562927246
officecrawl3_4,20,1,40,-20,-13.151727676391602,6.848272323608398
officecrawl3_4,20,2,27,-7,-2.201472282409668,4.798527717590332
officecrawl3_4,20,3,25,-5,-2.787835121154785,2.212164878845215
officecrawl3_5,28,1,48,-20,-14.815459251403809,5.184540748596191
officecrawl3_5,28,2,33,-5,-11.781421661376953,6.781421661376953
officecrawl3_5,28,3,21,7,6.091055870056152,0.9089441299438477
officecrawl3_6,27,1,47,-20,-18.75493812561035,1.2450618743896484
officecrawl3_7,30,1,48,-18,-11.202319145202637,6.797680854797363
officecrawl3_7,30,2,37,-7,-11.412338256835938,4.4123382568359375
officecrawl3_7,30,3,26,4,1.2364771366119385,2.7635228633880615
officecrawl3_8,20,1,40,-20,-12.762693405151367,7.237306594848633
officecrawl3_8,20,2,27,-7,-8.185028076171875,1.185028076171875
officecrawl3_9,26,1,46,-20,-7.85222053527832,12.14777946472168
officecrawl3_9,26,2,38,-12,-2.219587802886963,9.780412673950195
officecrawl3_9,26,3,36,-10,-9.382842063903809,0.6171579360961914
officeroom1_0,31,1,48,-17,-16.34130096435547,0.6586990356445312
officeroom1_1,33,1,48,-15,-14.044638633728027,0.9553613662719727
officeroom1_2,32,1,48,-16,-11.3896484375,4.6103515625
officeroom1_2,32,2,37,-5,-1.7170170545578003,3.28298282623291
officeroom1_2,32,3,35,-3,7.404809474945068,10.404809951782227
officeroom1_2,32,4,42,-10,-10.194357872009277,0.19435787200927734
officeroom1_3,36,1,48,-12,-8.564114570617676,3.435885429382324
officeroom1_3,36,2,39,-3,-4.450497150421143,1.4504971504211426
officeroom1_4,22,1,42,-20,-19.579938888549805,0.4200611114501953
officeroom1_5,21,1,41,-20,-20.53141975402832,0.5314197540283203
officeroom1_6,21,1,41,-20,-15.3099946975708,4.690005302429199
officeroom1_6,21,2,26,-5,-13.327939987182617,8.327939987182617
officeroom1_6,21,3,13,8,13.048229217529297,5.048229217529297
officeroom1_6,21,4,26,-5,-8.1616792678833,3.161679267883301
officeroom1_6,21,5,18,3,4.517828464508057,1.5178284645080566
officeroom1_7,29,1,48,-19,-4.9358296394348145,14.064170837402344
officeroom1_7,29,2,43,-14,-4.0569915771484375,9.943008422851562
officeroom1_7,29,3,39,-10,-2.64422869682312,7.355771064758301
officeroom1_7,29,4,36,-7,-1.542876958847046,5.457122802734375
officeroom1_7,29,5,34,-5,1.0869228839874268,6.086922645568848
officeroom1_7,29,6,35,-6,2.249566078186035,8.249566078186035
officeroom1_7,29,7,37,-8,-5.075206756591797,2.924793243408203
officeroom1_8,22,1,42,-20,-11.922592163085938,8.077407836914062
officeroom1_8,22,2,30,-8,-10.0530424118042,2.053042411804199
officeroom1_9,32,1,48,-16,-5.618795394897461,10.381204605102539
officeroom1_9,32,2,42,-10,-5.445674419403076,4.554325580596924
officeroom1_9,32,3,37,-5,-8.504828453063965,3.504828453063965
officeroom1_9,32,4,28,4,12.096487045288086,8.096487045288086
officeroom1_9,32,5,40,-8,-7.693784713745117,0.3062152862548828
officetrashshadows_1,38,1,48,-10,-4.687252044677734,5.312747955322266
officetrashshadows_1,38,2,43,-5,-5.599918365478516,0.5999183654785156
officetrashshadows_2,25,1,45,-20,-11.40865421295166,8.59134578704834
officetrashshadows_2,25,2,34,-9,-5.968450546264648,3.0315494537353516
officetrashshadows_2,25,3,28,-3,-3.982748508453369,0.9827485084533691
officetrashshadows_3,28,1,48,-20,-7.182832717895508,12.817167282104492
officetrashshadows_3,28,2,41,-13,-9.028489112854004,3.971510887145996
officetrashshadows_3,28,3,32,-4,-4.163444995880127,0.16344499588012695
officetrashshadows_4,44,1,48,-4,-22.02665138244629,18.02665138244629
officetrashshadows_4,44,2,26,18,14.667409896850586,3.332590103149414
officetrashshadows_4,44,3,41,3,-3.315316915512085,6.315317153930664
officetrashshadows_4,44,4,38,6,4.898467063903809,1.1015329360961914
officetrashshadows_8,25,1,45,-20,-17.97351837158203,2.0264816284179688
officetrashshadows_9,36,1,48,-12,-10.082425117492676,1.9175748825073242
officetrash_0,32,1,48,-16,-14.074686050415039,1.925313949584961
officetrash_1,24,1,44,-20,-23.267221450805664,3.267221450805664
officetrash_1,24,2,21,3,5.303757190704346,2.3037571907043457
officetrash_2,28,1,48,-20,-14.880524635314941,5.119475364685059
officetrash_2,28,2,33,-5,-7.978518486022949,2.978518486022949
officetrash_4,37,1,48,-11,-11.032504081726074,0.03250408172607422
officetrash_5,24,1,44,-20,-10.152691841125488,9.847308158874512
officetrash_5,24,2,34,-10,-9.414505958557129,0.5854940414428711
officetrash_6,23,1,43,-20,-11.779743194580078,8.220256805419922
officetrash_6,23,2,31,-8,-14.783466339111328,6.783466339111328
officetrash_6,23,3,16,7,8.093459129333496,1.093459129333496
officetrash_7,32,1,48,-16,-28.006582260131836,12.006582260131836
officetrash_7,32,2,20,12,10.95745849609375,1.04254150390625
officetrash_8,25,1,45,-20,-11.92992115020752,8.07007884979248
officetrash_8,25,2,33,-8,-10.967171669006348,2.9671716690063477
outdoorsbalcony1_0,24,1,44,-20,-23.3679141998291,3.3679141998291016
outdoorsbalcony1_0,24,2,21,3,0.6810814738273621,2.318918466567993
outdoorsbalcony1_1,24,1,44,-20,-22.266695022583008,2.266695022583008
outdoorsbalcony1_2,34,1,48,-14,-13.844152450561523,0.15584754943847656
outdoorsbalcony1_4,30,1,48,-18,-14.055142402648926,3.944857597351074
outdoorsbalcony1_4,30,2,34,-4,-7.128905296325684,3.1289052963256836
outdoorsbalcony1_4,30,3,27,3,-4.838181495666504,7.838181495666504
outdoorsbalcony1_4,30,4,22,8,6.388127326965332,1.611872673034668
outdoorsbalcony1_6,34,1,48,-14,-12.462242126464844,1.5377578735351562
outdoorsbalcony1_9,34,1,48,-14,-10.985156059265137,3.0148439407348633
outdoorsbalcony1_9,34,2,37,-3,-5.022195339202881,2.022195339202881
outdoorsbalcony2_0,23,1,43,-20,-8.678711891174316,11.321288108825684
outdoorsbalcony2_0,23,2,34,-11,-2.9396727085113525,8.060327529907227
outdoorsbalcony2_0,23,3,31,-8,-9.086014747619629,1.086014747619629
outdoorsbalcony2_1,29,1,48,-19,-12.608905792236328,6.391094207763672
outdoorsbalcony2_1,29,2,35,-6,-5.0710015296936035,0.9289984703063965
outdoorsbalcony2_2,40,1,48,-8,-9.199074745178223,1.1990747451782227
outdoorsbalcony2_4,23,1,43,-20,-0.5683081746101379,19.431692123413086
outdoorsbalcony2_4,23,2,42,-19,-6.455414772033691,12.544585227966309
outdoorsbalcony2_4,23,3,36,-13,-13.522174835205078,0.5221748352050781
outdoorsbalcony2_5,23,1,43,-20,-17.866273880004883,2.133726119995117
outdoorsbalcony2_6,28,1,48,-20,-9.430488586425781,10.569511413574219
outdoorsbalcony2_6,28,2,39,-11,-10.74492359161377,0.25507640838623047
outdoorsbalcony2_7,26,1,46,-20,-15.06849479675293,4.93150520324707
outdoorsbalcony2_7,26,2,31,-5,-2.7596123218536377,2.2403876781463623
outdoorsbalcony2_8,25,1,45,-20,-19.87454605102539,0.12545394897460938
outdoorsbalcony2_9,27,1,47,-20,-8.093324661254883,11.906675338745117
outdoorsbalcony2_9,27,2,39,-12,-11.884527206420898,0.11547279357910156
outdoorsfossils_3,23,1,43,-20,-15.758525848388672,4.241474151611328
outdoorsfossils_3,23,2,27,-4,-3.2344706058502197,0.7655293941497803
outdoorsfossils_5,21,1,41,-20,-13.420963287353516,6.579036712646484
outdoorsfossils_5,21,2,28,-7,-10.984875679016113,3.9848756790161133
outdoorsfossils_5,21,3,17,4,-0.5762245059013367,4.576224327087402
outdoorsfossils_5,21,4,16,5,0.11288120597600937,4.887118816375732
outdoorsfossils_5,21,5,16,5,0.9193356037139893,4.08066463470459
outdoorsfossils_5,21,6,17,4,4.75003719329834,0.7500371932983398
outdoorsfossils_6,24,1,44,-20,-16.539033889770508,3.460966110229492
outdoorsfossils_6,24,2,27,-3,-5.788630962371826,2.788630962371826
outdoorsfossils_7,23,1,43,-20,-24.81769561767578,4.817695617675781
outdoorsfossils_7,23,2,18,5,8.011394500732422,3.011394500732422
outdoorsfossils_7,23,3,26,-3,-5.466185569763184,2.4661855697631836
outdoorsfossils_8,24,1,44,-20,-12.185314178466797,7.814685821533203
outdoorsfossils_8,24,2,32,-8,-7.928633689880371,0.0713663101196289
outdoorsfossils_9,25,1,45,-20,-28.0390625,8.0390625
outdoorsfossils_9,25,2,17,8,7.8777337074279785,0.12226629257202148
outdoorsplants_0,40,1,48,-8,-10.01144027709961,2.0114402770996094
outdoorsplants_1,42,1,48,-6,-5.051491737365723,0.9485082626342773
outdoorsplants_2,25,1,45,-20,-18.628835678100586,1.371164321899414
outdoorsplants_3,23,1,43,-20,-14.44321060180664,5.556789398193359
outdoorsplants_3,23,2,29,-6,-4.414595603942871,1.585404396057129
outdoorsplants_6,26,1,46,-20,-26.330123901367188,6.3301239013671875
outdoorsplants_6,26,2,20,6,9.3941011428833,3.394101142883301
outdoorsplants_6,26,3,29,-3,-5.727748394012451,2.727748394012451
outdoorsplants_7,22,1,42,-20,-9.796117782592773,10.203882217407227
outdoorsplants_7,22,2,32,-10,-11.6427001953125,1.6427001953125
outdoorsplants_8,20,1,40,-20,-16.473161697387695,3.5268383026123047
outdoorsplants_8,20,2,24,-4,-4.7632551193237305,0.7632551193237305
outdoorsplants_9,22,1,42,-20,-12.509918212890625,7.490081787109375
outdoorsplants_9,22,2,29,-7,-9.436321258544922,2.436321258544922
photobox1_0,23,1,43,-20,-18.31348419189453,1.6865158081054688
photobox1_1,22,1,42,-20,-20.84726333618164,0.8472633361816406
photobox1_2,22,1,42,-20,-21.669544219970703,1.6695442199707031
photobox1_3,23,1,43,-20,-18.892250061035156,1.1077499389648438
photobox1_4,22,1,42,-20,-17.502599716186523,2.4974002838134766
photobox1_5,23,1,43,-20,-20.32703399658203,0.32703399658203125
photobox1_6,24,1,44,-20,-13.982467651367188,6.0175323486328125
photobox1_6,24,2,30,-6,-10.188413619995117,4.188413619995117
photobox1_6,24,3,20,4,4.530068874359131,0.5300688743591309
photobox1_7,23,1,43,-20,-33.061519622802734,13.061519622802734
photobox1_7,23,2,10,13,13.52916145324707,0.5291614532470703
