filename,CorrectPosition,focus_time,index,label,pred,loss
home1_0,29,1,14,15,52.997623443603516,37.997623443603516
home1_0,29,2,48,-19,-3.2283496856689453,15.771650314331055
home1_0,29,3,45,-16,-7.509020805358887,8.490979194641113
home1_0,29,4,37,-8,2.7714734077453613,10.771472930908203
home1_0,29,5,40,-11,-11.794970512390137,0.7949705123901367
home1_1,23,1,38,-15,-13.400667190551758,1.5993328094482422
home1_2,37,1,38,-1,-1.7642853260040283,0.7642853260040283
home1_3,32,1,39,-7,-12.170219421386719,5.170219421386719
home1_3,32,2,27,5,14.269135475158691,9.269135475158691
home1_3,32,3,41,-9,9.024811744689941,18.024810791015625
home1_3,32,4,48,-16,-9.389098167419434,6.610901832580566
home1_3,32,5,39,-7,4.676430702209473,11.676430702209473
home1_3,32,6,44,-12,3.0529067516326904,15.05290699005127
home1_3,32,7,47,-15,-6.6269307136535645,8.373069763183594
home1_3,32,8,40,-8,9.160058975219727,17.160058975219727
home1_3,32,9,48,-16,-8.270146369934082,7.729853630065918
home1_3,32,10,40,-8,2.8828020095825195,10.88280200958252
home1_4,47,1,41,6,8.929000854492188,2.9290008544921875
home1_5,47,1,19,28,22.3453311920166,5.654668807983398
home1_5,47,2,41,6,3.0766468048095703,2.9233531951904297
home1_6,34,1,35,-1,5.039523124694824,6.039523124694824
home1_6,34,2,40,-6,-7.041148662567139,1.0411486625671387
home1_8,29,1,9,20,9.42241096496582,10.57758903503418
home1_8,29,2,18,11,10.26623249053955,0.7337675094604492
home1_9,26,1,10,16,5.641359329223633,10.358640670776367
home1_9,26,2,16,10,2.176223039627075,7.823777198791504
home1_9,26,3,18,8,-3.3828258514404297,11.38282585144043
home1_9,26,4,15,11,-1.5425615310668945,12.542561531066895
home1_9,26,5,13,13,-3.3989381790161133,16.398937225341797
home1_9,26,6,10,16,4.019435882568359,11.98056411743164
home1_9,26,7,14,12,10.359452247619629,1.640547752380371
home2_0,38,1,34,4,6.449313640594482,2.4493136405944824
home2_2,43,1,9,34,-6.554910182952881,40.554908752441406
home2_2,43,2,2,41,5.196909427642822,35.8030891418457
home2_2,43,3,7,36,3.2363178730010986,32.7636833190918
home2_2,43,4,10,33,0.2811453938484192,32.71885299682617
home2_2,43,5,10,33,3.0704097747802734,29.929590225219727
home2_2,43,6,13,30,6.5216569900512695,23.478343963623047
home2_2,43,7,20,23,4.699054718017578,18.300945281982422
home2_2,43,8,25,18,3.2503716945648193,14.749628067016602
home2_2,43,9,28,15,3.5117685794830322,11.488231658935547
home2_2,43,10,32,11,8.022972106933594,2.9770278930664062
home2_3,31,1,41,-10,-5.557564735412598,4.442435264587402
home2_4,34,1,42,-8,-2.002857208251953,5.997142791748047
home2_4,34,2,40,-6,0.8183823823928833,6.818382263183594
home2_4,34,3,41,-7,7.798676490783691,14.798676490783691
home2_4,34,4,48,-14,9.48768138885498,23.487682342529297
home2_4,34,5,48,-14,1.3683338165283203,15.36833381652832
home2_4,34,6,48,-14,-0.8733915686607361,13.126608848571777
home2_4,34,7,47,-13,3.393749475479126,16.393749237060547
home2_4,34,8,48,-14,-1.3757015466690063,12.624298095703125
home2_4,34,9,47,-13,5.570915699005127,18.57091522216797
home2_4,34,10,48,-14,4.526182651519775,18.526182174682617
home2_5,30,1,39,-9,1.2777330875396729,10.277732849121094
home2_5,30,2,40,-10,-0.8464201092720032,9.153579711914062
home2_5,30,3,39,-9,-5.178579330444336,3.821420669555664
home2_6,29,1,26,3,-0.6829502582550049,3.682950258255005
home2_7,34,1,4,30,9.565403938293457,20.43459701538086
home2_7,34,2,14,20,7.440589904785156,12.559410095214844
home2_7,34,3,21,13,3.3690927028656006,9.63090705871582
home2_7,34,4,24,10,4.696726322174072,5.303273677825928
home2_7,34,5,29,5,2.8517909049987793,2.1482090950012207
home2_9,30,1,10,20,24.269378662109375,4.269378662109375
microkitchen1_0,21,1,1,20,27.760770797729492,7.760770797729492
microkitchen1_0,21,2,29,-8,-7.034566879272461,0.9654331207275391
microkitchen1_1,21,1,11,10,10.954484939575195,0.9544849395751953
microkitchen1_2,21,1,45,-24,-33.60986328125,9.60986328125
microkitchen1_2,21,2,11,10,8.482019424438477,1.5179805755615234
microkitchen1_3,24,1,47,-23,-13.30233097076416,9.69766902923584
microkitchen1_3,24,2,34,-10,-5.34891414642334,4.65108585357666
microkitchen1_4,25,1,16,9,10.802459716796875,1.802459716796875
microkitchen1_5,25,1,5,20,17.94172477722168,2.0582752227783203
microkitchen1_6,25,1,9,16,7.939357757568359,8.06064224243164
microkitchen1_6,25,2,17,8,2.9382078647613525,5.061792373657227
microkitchen1_6,25,3,20,5,-1.067488670349121,6.067488670349121
microkitchen1_6,25,4,19,6,3.7595763206481934,2.2404236793518066
microkitchen1_7,20,1,31,-11,-1.7544981241226196,9.245501518249512
microkitchen1_7,20,2,29,-9,-11.649371147155762,2.6493711471557617
microkitchen1_8,29,1,25,4,2.279888153076172,1.7201118469238281
microkitchen1_9,19,1,24,-5,-12.598642349243164,7.598642349243164
microkitchen1_9,19,2,11,8,2.7372636795043945,5.2627363204956055
microkitchen1_9,19,3,14,5,3.0114259719848633,1.9885740280151367
pillowroom1_0,25,1,48,-23,-4.190506935119629,18.809494018554688
pillowroom1_0,25,2,44,-19,1.1549395322799683,20.154939651489258
pillowroom1_0,25,3,45,-20,5.514875888824463,25.514875411987305
pillowroom1_0,25,4,48,-23,-7.125897407531738,15.874102592468262
pillowroom1_0,25,5,41,-16,1.7681496143341064,17.768150329589844
pillowroom1_0,25,6,43,-18,1.416335105895996,19.416336059570312
pillowroom1_0,25,7,44,-19,-2.3226447105407715,16.67735481262207
pillowroom1_0,25,8,42,-17,-0.46874088048934937,16.531259536743164
pillowroom1_0,25,9,42,-17,0.2009264975786209,17.200925827026367
pillowroom1_0,25,10,42,-17,-3.9067327976226807,13.093267440795898
pillowroom1_6,27,1,28,-1,5.50646448135376,6.50646448135376
pillowroom1_6,27,2,34,-7,-1.7437318563461304,5.25626802444458
pillowroom1_6,27,3,32,-5,5.024734973907471,10.024734497070312
pillowroom1_6,27,4,37,-10,-4.967142105102539,5.032857894897461
pillowroom1_6,27,5,32,-5,0.3799486458301544,5.379948616027832
pillowroom1_6,27,6,32,-5,1.7278083562850952,6.727808475494385
pillowroom1_6,27,7,34,-7,1.9413063526153564,8.941306114196777
pillowroom1_6,27,8,36,-9,-0.3389355540275574,8.661064147949219
pillowroom1_6,27,9,36,-9,-4.401052951812744,4.598947048187256
pillowroom1_7,36,1,7,29,24.209917068481445,4.790082931518555
pillowroom1_8,34,1,28,6,3.7700352668762207,2.2299647331237793
pillowroom1_9,21,1,24,-3,-2.0335710048675537,0.9664289951324463
secondfloorgames_0,20,1,8,12,7.079992771148682,4.920007228851318
secondfloorgames_1,24,1,24,0,7.759317398071289,7.759317398071289
secondfloorgames_1,24,2,32,-8,16.085037231445312,24.085037231445312
secondfloorgames_1,24,3,48,-24,27.307781219482422,51.30778121948242
secondfloorgames_1,24,4,48,-24,3.748528480529785,27.74852752685547
secondfloorgames_1,24,5,48,-24,28.637025833129883,52.63702392578125
secondfloorgames_1,24,6,48,-24,16.516197204589844,40.516197204589844
secondfloorgames_1,24,7,48,-24,28.53707504272461,52.53707504272461
secondfloorgames_1,24,8,48,-24,5.773380756378174,29.773380279541016
secondfloorgames_1,24,9,48,-24,-6.130672931671143,17.869327545166016
secondfloorgames_1,24,10,42,-18,1.0630677938461304,19.063068389892578
secondfloorgames_2,30,1,33,-3,-10.472260475158691,7.472260475158691
secondfloorgames_2,30,2,23,7,8.92628002166748,1.9262800216674805
secondfloorgames_3,23,1,33,-10,-7.95212984085083,2.04787015914917
secondfloorgames_4,22,1,16,6,1.8539366722106934,4.146063327789307
secondfloorgames_5,24,1,18,6,10.127620697021484,4.127620697021484
secondfloorgames_6,19,1,23,-4,24.449962615966797,28.449962615966797
secondfloorgames_6,19,2,47,-28,13.542097091674805,41.54209899902344
secondfloorgames_6,19,3,48,-29,9.07076644897461,38.07076644897461
secondfloorgames_6,19,4,48,-29,-5.71941614151001,23.28058433532715
secondfloorgames_6,19,5,42,-23,-0.7180131077766418,22.281986236572266
secondfloorgames_6,19,6,41,-22,-2.9749791622161865,19.025020599365234
secondfloorgames_6,19,7,38,-19,-11.05937671661377,7.9406232833862305
secondfloorgames_6,19,8,27,-8,-4.499917507171631,3.500082492828369
secondfloorgames_7,20,1,7,13,22.386831283569336,9.386831283569336
secondfloorgames_7,20,2,29,-9,-10.899077415466309,1.8990774154663086
secondfloorgames_8,23,1,15,8,4.8128461837768555,3.1871538162231445
apt1_0,25,1,18,7,6.203365802764893,0.7966341972351074
apt1_1,21,1,34,-13,-12.413092613220215,0.5869073867797852
apt1_2,24,1,1,23,24.219478607177734,1.2194786071777344
apt1_3,25,1,38,-13,-13.110491752624512,0.11049175262451172
apt1_4,23,1,8,15,4.376427173614502,10.623573303222656
apt1_4,23,2,12,11,1.8153023719787598,9.184698104858398
apt1_4,23,3,14,9,3.9102141857147217,5.089785575866699
apt1_4,23,4,18,5,2.5775463581085205,2.4224536418914795
apt1_5,22,1,10,12,4.617988586425781,7.382011413574219
apt1_5,22,2,15,7,0.14612706005573273,6.853872776031494
apt1_5,22,3,15,7,3.9962010383605957,3.0037989616394043
apt1_6,20,1,12,8,9.195596694946289,1.195596694946289
apt1_7,20,1,46,-26,-20.579795837402344,5.420204162597656
apt1_7,20,2,25,-5,-9.84489917755127,4.8448991775512695
apt1_8,31,1,16,15,19.27337074279785,4.273370742797852
apt1_9,20,1,45,-25,-21.596437454223633,3.403562545776367
apt2_0,41,1,12,29,24.821250915527344,4.178749084472656
apt2_1,20,1,10,10,5.686645030975342,4.313354969024658
apt2_2,23,1,14,9,7.749932765960693,1.2500672340393066
apt2_3,26,1,32,-6,15.277799606323242,21.277799606323242
apt2_3,26,2,47,-21,0.1558595895767212,21.155858993530273
apt2_3,26,3,47,-21,-7.679505348205566,13.320494651794434
apt2_3,26,4,39,-13,6.396028995513916,19.396028518676758
apt2_3,26,5,45,-19,-4.691040515899658,14.3089599609375
apt2_3,26,6,40,-14,3.4691452980041504,17.469144821166992
apt2_3,26,7,43,-17,11.367368698120117,28.367368698120117
apt2_3,26,8,48,-22,-9.87891674041748,12.12108325958252
apt2_3,26,9,38,-12,14.894580841064453,26.894580841064453
apt2_3,26,10,48,-22,-3.7708733081817627,18.2291259765625
apt2_4,23,1,30,-7,-6.289999008178711,0.7100009918212891
apt2_5,26,1,23,3,3.062380313873291,0.062380313873291016
apt2_6,23,1,15,8,-4.0182623863220215,12.01826286315918
apt2_6,23,2,11,12,-7.683014869689941,19.683013916015625
apt2_6,23,3,3,20,9.558355331420898,10.441644668579102
apt2_6,23,4,13,10,8.190983772277832,1.809016227722168
apt2_7,31,1,38,-7,-13.402799606323242,6.402799606323242
apt2_7,31,2,25,6,7.8172454833984375,1.8172454833984375
apt2_8,40,1,1,39,15.232471466064453,23.767528533935547
apt2_8,40,2,16,24,13.384764671325684,10.615235328674316
apt2_8,40,3,29,11,5.878964900970459,5.121035099029541
apt2_8,40,4,35,5,6.495991230010986,1.4959912300109863
apt2_9,24,1,14,10,6.2494587898254395,3.7505412101745605
books_0,27,1,36,-9,-9.925175666809082,0.925175666809082
books_1,26,1,33,-7,3.5813589096069336,10.581358909606934
books_1,26,2,37,-11,6.018598556518555,17.018598556518555
books_1,26,3,43,-17,-2.2025504112243652,14.797449111938477
books_1,26,4,41,-15,-3.522594690322876,11.477405548095703
books_1,26,5,37,-11,-8.041202545166016,2.9587974548339844
books_2,22,1,26,-4,1.2730172872543335,5.273017406463623
books_2,22,2,27,-5,-0.710768461227417,4.289231300354004
books_3,23,1,18,5,-5.305555820465088,10.30555534362793
books_3,23,2,13,10,-0.3159523606300354,10.31595230102539
books_3,23,3,13,10,2.3103625774383545,7.689637184143066
books_3,23,4,15,8,-0.685197114944458,8.685196876525879
books_3,23,5,14,9,6.009491443634033,2.990508556365967
books_4,24,1,39,-15,-2.167567491531372,12.832432746887207
books_4,24,2,37,-13,-4.7398881912231445,8.260111808776855
books_4,24,3,32,-8,-7.68995475769043,0.3100452423095703
books_5,22,1,8,14,9.345519065856934,4.654480934143066
books_6,20,1,27,-7,4.371520519256592,11.37152099609375
books_6,20,2,31,-11,-5.0803680419921875,5.9196319580078125
books_6,20,3,26,-6,1.5696463584899902,7.56964635848999
books_6,20,4,28,-8,0.6773791313171387,8.677379608154297
books_6,20,5,29,-9,4.084944725036621,13.084944725036621
books_6,20,6,33,-13,-3.841766595840454,9.158233642578125
books_6,20,7,29,-9,1.3479682207107544,10.347968101501465
books_6,20,8,30,-10,-4.7615966796875,5.2384033203125
books_6,20,9,25,-5,2.524510383605957,7.524510383605957
books_6,20,10,28,-8,4.240121841430664,12.240121841430664
books_7,26,1,6,20,5.28401517868042,14.715984344482422
books_7,26,2,11,15,3.9737548828125,11.0262451171875
books_7,26,3,15,11,4.888422966003418,6.111577033996582
books_7,26,4,20,6,3.7875986099243164,2.2124013900756836
books_8,23,1,12,11,4.832146167755127,6.167853832244873
books_8,23,2,17,6,5.363415718078613,0.6365842819213867
books_9,27,1,10,17,17.954910278320312,0.9549102783203125
bottles_0,22,1,9,13,7.497766971588135,5.502233028411865
bottles_0,22,2,16,6,6.048061370849609,0.048061370849609375
bottles_1,23,1,23,0,-2.3489491939544678,2.3489491939544678
bottles_2,22,1,21,1,-5.388939380645752,6.388939380645752
bottles_2,22,2,16,6,6.66881799697876,0.6688179969787598
bottles_3,30,1,25,5,13.868935585021973,8.868935585021973
bottles_3,30,2,39,-9,12.444446563720703,21.444446563720703
bottles_3,30,3,48,-18,3.3651609420776367,21.365161895751953
bottles_3,30,4,48,-18,-6.733034133911133,11.266965866088867
bottles_3,30,5,41,-11,11.047298431396484,22.047298431396484
bottles_3,30,6,48,-18,7.98818302154541,25.988182067871094
bottles_3,30,7,48,-18,11.79673957824707,29.79673957824707
bottles_3,30,8,48,-18,1.3353567123413086,19.335357666015625
bottles_3,30,9,48,-18,6.364258289337158,24.3642578125
bottles_3,30,10,48,-18,17.520395278930664,35.52039337158203
bottles_4,25,1,37,-12,-5.5436272621154785,6.4563727378845215
bottles_4,25,2,31,-6,-3.3366191387176514,2.6633808612823486
bottles_5,27,1,23,4,3.5402302742004395,0.45976972579956055
bottles_6,27,1,47,-20,-9.15760326385498,10.84239673614502
bottles_6,27,2,38,-11,10.73156452178955,21.731563568115234
bottles_6,27,3,48,-21,-6.910882949829102,14.089117050170898
bottles_6,27,4,41,-14,1.7615351676940918,15.76153564453125
bottles_6,27,5,43,-16,4.293774127960205,20.293773651123047
bottles_6,27,6,47,-20,-3.5926342010498047,16.407365798950195
bottles_6,27,7,43,-16,7.562592029571533,23.562591552734375
bottles_6,27,8,48,-21,-7.528079032897949,13.47192096710205
bottles_6,27,9,40,-13,8.761945724487305,21.761945724487305
bottles_6,27,10,48,-21,1.366092562675476,22.366092681884766
bottles_7,27,1,10,17,25.514385223388672,8.514385223388672
bottles_7,27,2,36,-9,-22.18560028076172,13.185600280761719
bottles_7,27,3,14,13,11.602958679199219,1.3970413208007812
bottles_8,25,1,43,-18,-10.27134895324707,7.72865104675293
bottles_8,25,2,33,-8,-4.2632670402526855,3.7367329597473145
campusoutdoors1_0,20,1,11,9,0.8411129713058472,8.158886909484863
campusoutdoors1_0,20,2,12,8,-1.5199246406555176,9.51992416381836
campusoutdoors1_0,20,3,10,10,-0.43037107586860657,10.430371284484863
campusoutdoors1_0,20,4,10,10,1.4392319917678833,8.560768127441406
campusoutdoors1_0,20,5,11,9,1.6790423393249512,7.320957660675049
campusoutdoors1_0,20,6,13,7,-4.927751064300537,11.927751541137695
campusoutdoors1_0,20,7,8,12,6.949141025543213,5.050858974456787
campusoutdoors1_0,20,8,15,5,-6.511447906494141,11.51144790649414
campusoutdoors1_0,20,9,8,12,2.1786935329437256,9.821306228637695
campusoutdoors1_0,20,10,10,10,2.84320330619812,7.156796455383301
campusoutdoors1_1,20,1,32,-12,-13.847854614257812,1.8478546142578125
campusoutdoors1_2,22,1,14,8,3.5584874153137207,4.441512584686279
campusoutdoors1_3,20,1,4,16,6.9860639572143555,9.013936042785645
campusoutdoors1_3,20,2,11,9,-4.169194221496582,13.169194221496582
campusoutdoors1_3,20,3,7,13,3.0313527584075928,9.968647003173828
campusoutdoors1_3,20,4,10,10,4.281772613525391,5.718227386474609
campusoutdoors1_3,20,5,14,6,-5.167788505554199,11.1677885055542
campusoutdoors1_3,20,6,9,11,2.7137293815612793,8.286270141601562
campusoutdoors1_3,20,7,12,8,-1.2158869504928589,9.215887069702148
campusoutdoors1_3,20,8,11,9,-2.7936179637908936,11.793618202209473
campusoutdoors1_3,20,9,8,12,5.552675247192383,6.447324752807617
campusoutdoors1_3,20,10,14,6,-4.117915630340576,10.117916107177734
campusoutdoors1_4,22,1,21,1,-3.470857858657837,4.470857620239258
campusoutdoors1_5,22,1,45,-23,-13.016178131103516,9.983821868896484
campusoutdoors1_5,22,2,32,-10,-3.3742942810058594,6.625705718994141
campusoutdoors1_5,22,3,29,-7,-13.648688316345215,6.648688316345215
campusoutdoors1_5,22,4,15,7,1.6163504123687744,5.383649826049805
campusoutdoors1_5,22,5,17,5,3.3266103267669678,1.6733896732330322
campusoutdoors1_6,27,1,19,8,19.354122161865234,11.354122161865234
campusoutdoors1_6,27,2,38,-11,-5.576113700866699,5.423886299133301
campusoutdoors1_6,27,3,32,-5,3.643902540206909,8.643902778625488
campusoutdoors1_6,27,4,36,-9,-4.585030555725098,4.414969444274902
campusoutdoors1_8,19,1,11,8,0.8087795376777649,7.191220283508301
campusoutdoors1_8,19,2,12,7,1.2721635103225708,5.727836608886719
campusoutdoors1_8,19,3,13,6,4.169458866119385,1.8305411338806152
campusoutdoors1_9,19,1,30,-11,24.6224422454834,35.62244415283203
campusoutdoors1_9,19,2,48,-29,10.131689071655273,39.131690979003906
campusoutdoors1_9,19,3,48,-29,-11.73038387298584,17.269615173339844
campusoutdoors1_9,19,4,36,-17,11.623764991760254,28.623764038085938
campusoutdoors1_9,19,5,48,-29,16.17778778076172,45.17778778076172
campusoutdoors1_9,19,6,48,-29,7.534302234649658,36.5343017578125
campusoutdoors1_9,19,7,48,-29,10.248154640197754,39.24815368652344
campusoutdoors1_9,19,8,48,-29,9.017495155334473,38.017494201660156
campusoutdoors1_9,19,9,48,-29,-2.1616337299346924,26.83836555480957
campusoutdoors1_9,19,10,46,-27,34.308738708496094,61.308738708496094
campusoutdoors2_0,20,1,45,-25,-6.819746494293213,18.180253982543945
campusoutdoors2_0,20,2,38,-18,-4.493090629577637,13.506909370422363
campusoutdoors2_0,20,3,34,-14,-5.874632835388184,8.125367164611816
campusoutdoors2_0,20,4,28,-8,-5.941945552825928,2.0580544471740723
campusoutdoors2_1,42,1,27,15,10.494791984558105,4.5052080154418945
campusoutdoors2_3,31,1,39,-8,-4.745537757873535,3.254462242126465
campusoutdoors2_4,29,1,24,5,8.849989891052246,3.849989891052246
campusoutdoors2_5,32,1,13,19,12.365074157714844,6.634925842285156
campusoutdoors2_5,32,2,25,7,3.2174246311187744,3.7825753688812256
campusoutdoors2_6,22,1,45,-23,4.341102600097656,27.341102600097656
campusoutdoors2_6,22,2,48,-26,8.358867645263672,34.35886764526367
campusoutdoors2_6,22,3,48,-26,-8.065485000610352,17.93451499938965
campusoutdoors2_6,22,4,40,-18,9.256155014038086,27.256155014038086
campusoutdoors2_6,22,5,48,-26,-6.951612949371338,19.04838752746582
campusoutdoors2_6,22,6,41,-19,2.3628995418548584,21.362899780273438
campusoutdoors2_6,22,7,43,-21,12.271476745605469,33.27147674560547
campusoutdoors2_6,22,8,48,-26,-5.0309038162231445,20.969097137451172
campusoutdoors2_6,22,9,43,-21,7.352903842926025,28.352903366088867
campusoutdoors2_6,22,10,48,-26,2.395108938217163,28.395109176635742
campusoutdoors2_7,23,1,26,-3,4.78285026550293,7.78285026550293
campusoutdoors2_7,23,2,31,-8,-11.176114082336426,3.176114082336426
campusoutdoors2_8,23,1,19,4,-2.9705841541290283,6.970583915710449
campusoutdoors2_8,23,2,16,7,5.299227714538574,1.7007722854614258
campusoutdoors2_9,25,1,10,15,11.304727554321289,3.695272445678711
fakeplants_0,24,1,34,-10,-3.1090810298919678,6.890918731689453
fakeplants_0,24,2,31,-7,0.41435694694519043,7.4143571853637695
fakeplants_0,24,3,31,-7,0.6961074471473694,7.696107387542725
fakeplants_0,24,4,32,-8,0.064729705452919,8.064729690551758
fakeplants_0,24,5,32,-8,2.7450621128082275,10.745061874389648
fakeplants_0,24,6,35,-11,1.6803027391433716,12.680302619934082
fakeplants_0,24,7,37,-13,1.0273703336715698,14.02737045288086
fakeplants_0,24,8,38,-14,5.151088237762451,19.15108871459961
fakeplants_0,24,9,43,-19,-13.683503150939941,5.316496849060059
fakeplants_0,24,10,29,-5,3.325937032699585,8.325937271118164
fakeplants_1,21,1,41,-20,-13.157390594482422,6.842609405517578
fakeplants_1,21,2,28,-7,-5.717668056488037,1.282331943511963
fakeplants_2,21,1,5,16,7.998162269592285,8.001837730407715
fakeplants_2,21,2,13,8,6.178133487701416,1.821866512298584
fakeplants_3,22,1,33,-11,0.8175579905509949,11.817558288574219
fakeplants_3,22,2,34,-12,-1.3084511756896973,10.691549301147461
fakeplants_3,22,3,33,-11,0.9608120918273926,11.960811614990234
fakeplants_3,22,4,34,-12,7.722295761108398,19.7222957611084
fakeplants_3,22,5,42,-20,2.46486234664917,22.464862823486328
fakeplants_3,22,6,44,-22,1.8090471029281616,23.80904769897461
fakeplants_3,22,7,46,-24,1.3544142246246338,25.354413986206055
fakeplants_3,22,8,47,-25,3.3179593086242676,28.31795883178711
fakeplants_3,22,9,48,-26,-2.3166980743408203,23.68330192565918
fakeplants_3,22,10,46,-24,0.7474790215492249,24.747478485107422
fakeplants_4,24,1,3,21,19.05233383178711,1.9476661682128906
fakeplants_5,21,1,8,13,20.333606719970703,7.333606719970703
fakeplants_5,21,2,28,-7,-3.649094581604004,3.350905418395996
fakeplants_6,21,1,27,-6,-6.665459632873535,0.6654596328735352
fakeplants_7,23,1,5,18,13.59765625,4.40234375
fakeplants_8,21,1,29,-8,-7.942025661468506,0.05797433853149414
fakeplants_9,21,1,17,4,-0.011149665340781212,4.011149883270264
garage2_0,22,1,10,12,9.33610725402832,2.6638927459716797
garage2_1,24,1,23,1,-2.7746081352233887,3.7746081352233887
garage2_2,31,1,13,18,22.989402770996094,4.989402770996094
garage2_4,24,1,15,9,4.718235969543457,4.281764030456543
garage2_6,26,1,25,1,16.41229248046875,15.41229248046875
garage2_6,26,2,41,-15,0.43800875544548035,15.438008308410645
garage2_6,26,3,41,-15,-5.590395450592041,9.409605026245117
garage2_6,26,4,35,-9,6.968067646026611,15.968067169189453
garage2_6,26,5,42,-16,7.972270965576172,23.972270965576172
garage2_6,26,6,48,-22,-15.636242866516113,6.363757133483887
garage2_6,26,7,32,-6,-0.8954783082008362,5.104521751403809
garage2_6,26,8,31,-5,7.342502593994141,12.34250259399414
garage2_6,26,9,38,-12,12.755561828613281,24.75556182861328
garage2_6,26,10,48,-22,3.956460952758789,25.95646095275879
garage2_7,24,1,31,-7,-10.463910102844238,3.4639101028442383
garage2_8,21,1,0,21,15.04712200164795,5.952877998352051
garage2_8,21,2,15,6,1.5602173805236816,4.439782619476318
garage2_9,23,1,46,-23,5.145942687988281,28.14594268798828
garage2_9,23,2,48,-25,-3.2399649620056152,21.760034561157227
garage2_9,23,3,45,-22,-5.938804626464844,16.061195373535156
garage2_9,23,4,39,-16,1.0423612594604492,17.042362213134766
garage2_9,23,5,40,-17,-0.6663971543312073,16.333602905273438
garage2_9,23,6,39,-16,-6.962449550628662,9.03754997253418
garage2_9,23,7,32,-9,-6.749514102935791,2.250485897064209
garage_0,25,1,34,-9,5.819038391113281,14.819038391113281
garage_0,25,2,40,-15,-3.377535581588745,11.622464179992676
garage_0,25,3,37,-12,-1.5124810934066772,10.487519264221191
garage_0,25,4,35,-10,-4.561000823974609,5.438999176025391
garage_0,25,5,30,-5,6.470228672027588,11.47022819519043
garage_0,25,6,36,-11,-1.463758111000061,9.53624153137207
garage_0,25,7,35,-10,-0.07134684920310974,9.9286527633667
garage_0,25,8,35,-10,0.6901662349700928,10.690166473388672
garage_0,25,9,36,-11,1.8949772119522095,12.894977569580078
garage_0,25,10,38,-13,-5.647058963775635,7.352941036224365
garage_1,27,1,19,8,6.128396987915039,1.871603012084961
garage_3,22,1,22,0,3.155824661254883,3.155824661254883
garage_4,44,1,11,33,16.43992042541504,16.56007957458496
garage_4,44,2,27,17,2.4339044094085693,14.566095352172852
garage_4,44,3,29,15,6.2708210945129395,8.729179382324219
garage_4,44,4,35,9,4.769288063049316,4.230711936950684
garage_6,27,1,25,2,1.4280925989151,0.5719074010848999
garage_7,22,1,44,-22,-9.92789077758789,12.07210922241211
garage_7,22,2,34,-12,-5.100994110107422,6.899005889892578
garage_7,22,3,29,-7,-2.8842577934265137,4.115742206573486
garage_8,44,1,7,37,51.614662170410156,14.614662170410156
garage_8,44,2,48,-4,-8.533608436584473,4.533608436584473
garage_9,20,1,18,2,3.83848237991333,1.83848237991333
hallway1_0,32,1,31,1,1.5329887866973877,0.5329887866973877
hallway1_2,33,1,30,3,6.074123382568359,3.0741233825683594
hallway1_3,26,1,25,1,0.6938331723213196,0.3061668276786804
hallway1_4,23,1,42,-19,-6.966742515563965,12.033257484436035
hallway1_4,23,2,35,-12,-8.374937057495117,3.625062942504883
hallway1_5,22,1,19,3,-5.039829730987549,8.03982925415039
hallway1_5,22,2,14,8,-3.600881338119507,11.600881576538086
hallway1_5,22,3,10,12,6.104413986206055,5.895586013793945
hallway1_5,22,4,16,6,1.141930103302002,4.858069896697998
hallway1_6,22,1,20,2,5.821306228637695,3.8213062286376953
hallway1_7,37,1,13,24,21.361515045166016,2.6384849548339844
hallway2_0,29,1,31,-2,13.776626586914062,15.776626586914062
hallway2_0,29,2,45,-16,2.9195895195007324,18.91958999633789
hallway2_0,29,3,48,-19,-10.932615280151367,8.067384719848633
hallway2_0,29,4,37,-8,4.693446159362793,12.693446159362793
hallway2_0,29,5,42,-13,-0.6900888681411743,12.309910774230957
hallway2_0,29,6,41,-12,-9.908836364746094,2.0911636352539062
hallway2_1,34,1,20,14,4.789231300354004,9.210768699645996
hallway2_1,34,2,25,9,2.708939552307129,6.291060447692871
hallway2_1,34,3,28,6,3.7405600547790527,2.2594399452209473
hallway2_2,25,1,11,14,26.57244873046875,12.57244873046875
hallway2_2,25,2,38,-13,-10.1654052734375,2.8345947265625
meetingroom1_7,19,1,42,-23,20.835025787353516,43.835025787353516
meetingroom1_7,19,2,48,-29,20.020170211791992,49.020172119140625
meetingroom1_7,19,3,48,-29,4.358071804046631,33.358070373535156
meetingroom1_7,19,4,48,-29,25.708112716674805,54.70811462402344
meetingroom1_7,19,5,48,-29,23.82801055908203,52.82801055908203
meetingroom1_7,19,6,48,-29,14.274316787719727,43.274314880371094
meetingroom1_7,19,7,48,-29,18.28848648071289,47.28848648071289
meetingroom1_7,19,8,48,-29,3.1840126514434814,32.18401336669922
meetingroom1_7,19,9,48,-29,13.408001899719238,42.40800094604492
meetingroom1_7,19,10,48,-29,-0.9669107794761658,28.03308868408203
meetingroom1_8,21,1,37,-16,0.29798123240470886,16.29798126220703
meetingroom1_8,21,2,37,-16,23.651554107666016,39.651554107666016
meetingroom1_8,21,3,48,-27,-5.15172004699707,21.84827995300293
meetingroom1_8,21,4,43,-22,5.892916679382324,27.89291763305664
meetingroom1_8,21,5,48,-27,-9.638839721679688,17.361160278320312
meetingroom1_8,21,6,38,-17,-8.001655578613281,8.998344421386719
meetingroom1_8,21,7,30,-9,1.7535723447799683,10.753572463989258
meetingroom1_8,21,8,32,-11,-3.544257640838623,7.455742359161377
meetingroom1_8,21,9,28,-7,-9.969649314880371,2.969649314880371
meetingroom1_9,23,1,38,-15,-24.359201431274414,9.359201431274414
meetingroom1_9,23,2,14,9,23.729413986206055,14.729413986206055
meetingroom1_9,23,3,38,-15,-14.121922492980957,0.878077507019043
meetingroom2_0,27,1,22,5,-1.2348653078079224,6.234865188598633
meetingroom2_0,27,2,21,6,3.806023597717285,2.193976402282715
meetingroom2_1,23,1,0,23,15.450325012207031,7.549674987792969
meetingroom2_1,23,2,15,8,17.872079849243164,9.872079849243164
meetingroom2_1,23,3,33,-10,-3.4806792736053467,6.519320487976074
meetingroom2_1,23,4,30,-7,-9.468301773071289,2.468301773071289
meetingroom2_2,24,1,37,-13,-7.6064534187316895,5.3935465812683105
meetingroom2_2,24,2,29,-5,-4.769314289093018,0.23068571090698242
meetingroom2_3,29,1,40,-11,-1.6818243265151978,9.318175315856934
meetingroom2_3,29,2,38,-9,0.045917391777038574,9.045917510986328
meetingroom2_3,29,3,38,-9,-5.582386493682861,3.4176135063171387
meetingroom2_4,22,1,4,18,7.719429969787598,10.280570030212402
meetingroom2_4,22,2,12,10,2.3599047660827637,7.640095233917236
meetingroom2_4,22,3,14,8,3.166301965713501,4.833698272705078
meetingroom2_5,24,1,46,-22,5.420446872711182,27.420446395874023
meetingroom2_5,24,2,48,-24,4.8631510734558105,28.86315155029297
meetingroom2_5,24,3,48,-24,5.500807762145996,29.500808715820312
meetingroom2_5,24,4,48,-24,6.8097825050354,30.809782028198242
meetingroom2_5,24,5,48,-24,5.220981121063232,29.22098159790039
meetingroom2_5,24,6,48,-24,3.290086507797241,27.29008674621582
meetingroom2_5,24,7,48,-24,5.766857147216797,29.766857147216797
meetingroom2_5,24,8,48,-24,4.9364495277404785,28.93644905090332
meetingroom2_5,24,9,48,-24,3.2279860973358154,27.227985382080078
meetingroom2_5,24,10,48,-24,0.8356149196624756,24.835615158081055
meetingroom2_6,26,1,8,18,19.732128143310547,1.7321281433105469
meetingroom2_7,28,1,16,12,18.62230682373047,6.622306823730469
meetingroom2_7,28,2,35,-7,0.5713833570480347,7.571383476257324
meetingroom2_7,28,3,36,-8,-9.398466110229492,1.3984661102294922
meetingroom2_8,28,1,0,28,44.539817810058594,16.539817810058594
meetingroom2_8,28,2,45,-17,-14.871257781982422,2.128742218017578
meetingroom2_9,31,1,43,-12,-5.159153461456299,6.840846538543701
meetingroom2_9,31,2,38,-7,-4.830060958862305,2.1699390411376953
officecrawl1_0,26,1,2,24,26.50692367553711,2.5069236755371094
officecrawl1_1,36,1,1,35,10.604805946350098,24.39519500732422
officecrawl1_1,36,2,12,24,11.21514892578125,12.78485107421875
officecrawl1_1,36,3,23,13,3.582521438598633,9.417478561401367
officecrawl1_1,36,4,27,9,4.579678535461426,4.420321464538574
officecrawl1_2,26,1,22,4,-1.0070208311080933,5.007020950317383
officecrawl1_2,26,2,21,5,1.3175233602523804,3.68247652053833
officecrawl1_3,21,1,17,4,-6.786457061767578,10.786457061767578
officecrawl1_3,21,2,10,11,-3.9041831493377686,14.904183387756348
officecrawl1_3,21,3,6,15,-12.063048362731934,27.06304931640625
officecrawl1_3,21,4,0,21,-13.897229194641113,34.8972282409668
officecrawl1_3,21,5,0,21,-5.199939727783203,26.199939727783203
officecrawl1_3,21,6,0,21,6.953622341156006,14.046377182006836
officecrawl1_3,21,7,7,14,5.195679187774658,8.8043212890625
officecrawl1_3,21,8,12,9,1.3868759870529175,7.613123893737793
officecrawl1_3,21,9,13,8,2.6600067615509033,5.339993476867676
officecrawl1_3,21,10,16,5,2.318969249725342,2.681030750274658
officecrawl1_4,31,1,37,-6,4.278195858001709,10.278196334838867
officecrawl1_4,31,2,41,-10,-6.737634181976318,3.2623658180236816
officecrawl1_5,23,1,47,-24,0.9824438691139221,24.982444763183594
officecrawl1_5,23,2,48,-25,-4.072651386260986,20.927349090576172
officecrawl1_5,23,3,44,-21,2.3478071689605713,23.347806930541992
officecrawl1_5,23,4,46,-23,-4.65113639831543,18.34886360168457
officecrawl1_5,23,5,41,-18,-2.1453285217285156,15.854671478271484
officecrawl1_5,23,6,39,-16,1.8161641359329224,17.816164016723633
officecrawl1_5,23,7,41,-18,-6.057618618011475,11.942380905151367
officecrawl1_5,23,8,35,-12,-0.8394793272018433,11.160520553588867
officecrawl1_5,23,9,34,-11,-6.760568618774414,4.239431381225586
officecrawl1_6,27,1,42,-15,20.2929744720459,35.29297637939453
officecrawl1_6,27,2,48,-21,9.491835594177246,30.491836547851562
officecrawl1_6,27,3,48,-21,12.430110931396484,33.430110931396484
officecrawl1_6,27,4,48,-21,17.067134857177734,38.067134857177734
officecrawl1_6,27,5,48,-21,15.70758056640625,36.70758056640625
officecrawl1_6,27,6,48,-21,2.8988099098205566,23.8988094329834
officecrawl1_6,27,7,48,-21,-9.874183654785156,11.125816345214844
officecrawl1_6,27,8,38,-11,-5.709137916564941,5.290862083435059
officecrawl1_6,27,9,32,-5,17.57493019104004,22.57493019104004
officecrawl1_6,27,10,48,-21,2.4694693088531494,23.46946907043457
officecrawl1_7,20,1,5,15,40.02871322631836,25.02871322631836
officecrawl1_7,20,2,45,-25,-7.407275199890137,17.592723846435547
officecrawl1_7,20,3,38,-18,0.23966005444526672,18.239660263061523
officecrawl1_7,20,4,38,-18,-6.454306602478027,11.545693397521973
officecrawl1_7,20,5,32,-12,1.5048271417617798,13.504827499389648
officecrawl1_7,20,6,34,-14,8.522893905639648,22.52289390563965
officecrawl1_7,20,7,43,-23,-8.862531661987305,14.137468338012695
officecrawl1_7,20,8,34,-14,1.5098007917404175,15.509800910949707
officecrawl1_7,20,9,36,-16,0.6804171204566956,16.680418014526367
officecrawl1_7,20,10,37,-17,0.835763692855835,17.835763931274414
officecrawl1_8,32,1,28,4,8.598542213439941,4.598542213439941
officecrawl1_9,33,1,34,-1,3.650163412094116,4.650163650512695
officecrawl2_0,31,1,7,24,5.942708969116211,18.05729103088379
officecrawl2_0,31,2,13,18,-1.4128875732421875,19.412887573242188
officecrawl2_0,31,3,12,19,3.935407876968384,15.064592361450195
officecrawl2_0,31,4,16,15,1.7082715034484863,13.291728973388672
officecrawl2_0,31,5,18,13,3.5474257469177246,9.452573776245117
officecrawl2_0,31,6,22,9,1.6342235803604126,7.365776538848877
officecrawl2_0,31,7,24,7,-0.5187951326370239,7.518795013427734
officecrawl2_0,31,8,23,8,0.23215505480766296,7.767845153808594
officecrawl2_0,31,9,23,8,0.8936508297920227,7.106348991394043
officecrawl2_0,31,10,24,7,2.6460483074188232,4.353951454162598
officecrawl2_1,24,1,33,-9,-1.5233174562454224,7.476682662963867
officecrawl2_1,24,2,31,-7,-11.211198806762695,4.211198806762695
officecrawl2_2,48,1,31,17,4.601932048797607,12.398067474365234
officecrawl2_2,48,2,36,12,2.9222378730773926,9.077762603759766
officecrawl2_2,48,3,39,9,0.8817185163497925,8.118281364440918
officecrawl2_2,48,4,40,8,0.683030366897583,7.316969871520996
officecrawl2_2,48,5,41,7,4.230976104736328,2.769023895263672
officecrawl2_3,42,1,29,13,15.294354438781738,2.2943544387817383
officecrawl2_4,24,1,8,16,9.091978073120117,6.908021926879883
officecrawl2_4,24,2,17,7,1.833847999572754,5.166152000427246
officecrawl2_4,24,3,19,5,-0.026084188371896744,5.0260844230651855
officecrawl2_4,24,4,19,5,-1.0702178478240967,6.070218086242676
officecrawl2_4,24,5,18,6,-0.5931034684181213,6.593103408813477
officecrawl2_4,24,6,17,7,2.173527717590332,4.826472282409668
officecrawl2_6,28,1,41,-13,-9.440455436706543,3.559544563293457
officecrawl2_7,33,1,46,-13,-9.901284217834473,3.0987157821655273
officecrawl2_8,22,1,14,8,6.684249401092529,1.3157505989074707
officecrawl2_9,27,1,1,26,6.643762111663818,19.356237411499023
officecrawl2_9,27,2,8,19,6.024352073669434,12.975647926330566
officecrawl2_9,27,3,14,13,7.0740966796875,5.9259033203125
officecrawl2_9,27,4,21,6,6.19888162612915,0.1988816261291504
officecrawl3_1,26,1,31,-5,0.70127934217453,5.701279163360596
officecrawl3_1,26,2,32,-6,-2.931220769882202,3.068779230117798
officecrawl3_2,24,1,10,14,5.337982177734375,8.662017822265625
officecrawl3_2,24,2,15,9,-2.4336583614349365,11.433658599853516
officecrawl3_2,24,3,13,11,6.157410621643066,4.842589378356934
officecrawl3_3,32,1,24,8,2.96592378616333,5.03407621383667
officecrawl3_3,32,2,27,5,3.066211462020874,1.933788537979126
officecrawl3_4,20,1,12,8,4.826113700866699,3.173886299133301
officecrawl3_5,27,1,29,-2,7.44794225692749,9.447942733764648
officecrawl3_5,27,2,36,-9,-0.793071985244751,8.206928253173828
officecrawl3_5,27,3,35,-8,-4.7013840675354,3.2986159324645996
officecrawl3_6,26,1,21,5,9.671051979064941,4.671051979064941
officecrawl3_7,28,1,42,-14,0.2876073718070984,14.287607192993164
officecrawl3_7,28,2,42,-14,-1.654049038887024,12.345951080322266
officecrawl3_7,28,3,40,-12,1.4791306257247925,13.479130744934082
officecrawl3_7,28,4,41,-13,1.837783694267273,14.837783813476562
officecrawl3_7,28,5,43,-15,-0.09965117275714874,14.900348663330078
officecrawl3_7,28,6,43,-15,-4.510284423828125,10.489715576171875
officecrawl3_7,28,7,38,-10,-0.9387221336364746,9.061277389526367
officecrawl3_7,28,8,37,-9,-5.114923000335693,3.8850769996643066
officecrawl3_8,19,1,34,-15,-13.673016548156738,1.3269834518432617
officecrawl3_9,25,1,25,0,-2.958549737930298,2.958549737930298
officeroom1_0,27,1,37,-10,11.917142868041992,21.917142868041992
officeroom1_0,27,2,48,-21,-5.142580986022949,15.85741901397705
officeroom1_0,27,3,43,-16,11.266478538513184,27.2664794921875
officeroom1_0,27,4,48,-21,16.51323699951172,37.51323699951172
officeroom1_0,27,5,48,-21,10.881254196166992,31.881254196166992
officeroom1_0,27,6,48,-21,7.621896266937256,28.621896743774414
officeroom1_0,27,7,48,-21,23.84984588623047,44.84984588623047
officeroom1_0,27,8,48,-21,3.762287139892578,24.762287139892578
officeroom1_0,27,9,48,-21,4.375724792480469,25.37572479248047
officeroom1_0,27,10,48,-21,3.7123348712921143,24.71233558654785
officeroom1_1,28,1,10,18,11.816886901855469,6.183113098144531
officeroom1_1,28,2,22,6,5.7132439613342285,0.2867560386657715
officeroom1_2,29,1,4,25,21.900516510009766,3.0994834899902344
officeroom1_3,29,1,48,-19,-20.9392147064209,1.9392147064208984
officeroom1_4,21,1,36,-15,9.226231575012207,24.22623062133789
officeroom1_4,21,2,45,-24,-11.294825553894043,12.705174446105957
officeroom1_4,21,3,34,-13,-7.42789363861084,5.57210636138916
officeroom1_4,21,4,27,-6,-10.47256088256836,4.472560882568359
officeroom1_5,22,1,1,21,6.19033670425415,14.809663772583008
officeroom1_5,22,2,7,15,5.430986404418945,9.569013595581055
officeroom1_5,22,3,12,10,4.473790645599365,5.526209354400635
officeroom1_5,22,4,16,6,0.7282881140708923,5.271711826324463
officeroom1_5,22,5,17,5,1.7305916547775269,3.2694082260131836
officeroom1_6,22,1,47,-25,1.2815728187561035,26.281572341918945
officeroom1_6,22,2,48,-26,-8.517388343811035,17.48261260986328
officeroom1_6,22,3,39,-17,-11.000626564025879,5.999373435974121
officeroom1_6,22,4,28,-6,-10.181710243225098,4.181710243225098
officeroom1_7,22,1,1,21,1.895304799079895,19.104694366455078
officeroom1_7,22,2,3,19,-4.868754863739014,23.868755340576172
officeroom1_7,22,3,0,22,7.141873359680176,14.858126640319824
officeroom1_7,22,4,7,15,3.8681552410125732,11.131844520568848
officeroom1_7,22,5,11,11,-4.327330589294434,15.327330589294434
officeroom1_7,22,6,7,15,-5.243820667266846,20.243820190429688
officeroom1_7,22,7,2,20,2.7110376358032227,17.288963317871094
officeroom1_7,22,8,5,17,7.818692684173584,9.181306838989258
officeroom1_7,22,9,13,9,-2.4522323608398438,11.452232360839844
officeroom1_7,22,10,11,11,1.4373369216918945,9.562663078308105
officeroom1_8,22,1,2,20,11.022260665893555,8.977739334106445
officeroom1_8,22,2,13,9,5.363152980804443,3.6368470191955566
officeroom1_9,27,1,30,-3,-2.241299867630005,0.7587001323699951
officetrashshadows_1,34,1,46,-12,4.796020030975342,16.7960205078125
officetrashshadows_1,34,2,48,-14,-1.6371046304702759,12.362895011901855
officetrashshadows_1,34,3,46,-12,4.5082926750183105,16.50829315185547
officetrashshadows_1,34,4,48,-14,2.513838768005371,16.513839721679688
officetrashshadows_1,34,5,48,-14,-3.3161566257476807,10.683843612670898
officetrashshadows_1,34,6,45,-11,5.135379314422607,16.135379791259766
officetrashshadows_1,34,7,48,-14,-3.284290313720703,10.715709686279297
officetrashshadows_1,34,8,45,-11,1.9298436641693115,12.92984390258789
officetrashshadows_1,34,9,47,-13,3.025249719619751,16.025249481201172
officetrashshadows_1,34,10,48,-14,1.678162693977356,15.678162574768066
officetrashshadows_2,23,1,24,-1,1.1866204738616943,2.1866204738616943
officetrashshadows_3,27,1,42,-15,-10.180791854858398,4.819208145141602
officetrashshadows_4,36,1,34,2,-2.1052963733673096,4.1052961349487305
officetrashshadows_5,39,1,2,37,3.707557439804077,33.292442321777344
officetrashshadows_5,39,2,6,33,5.499948978424072,27.500051498413086
officetrashshadows_5,39,3,11,28,3.4311885833740234,24.568811416625977
officetrashshadows_5,39,4,14,25,3.6670620441436768,21.332937240600586
officetrashshadows_5,39,5,18,21,-1.2534552812576294,22.253456115722656
officetrashshadows_5,39,6,17,22,2.3587448596954346,19.641254425048828
officetrashshadows_5,39,7,19,20,11.173247337341309,8.826752662658691
officetrashshadows_5,39,8,30,9,-0.24630257487297058,9.246302604675293
officetrashshadows_5,39,9,30,9,-2.6463091373443604,11.646308898925781
officetrashshadows_5,39,10,27,12,-1.8076058626174927,13.807605743408203
officetrashshadows_6,37,1,36,1,-2.8520593643188477,3.8520593643188477
officetrashshadows_8,25,1,7,18,7.968784809112549,10.03121566772461
officetrashshadows_8,25,2,15,10,2.6552462577819824,7.344753742218018
officetrashshadows_8,25,3,18,7,1.2914304733276367,5.708569526672363
officetrashshadows_8,25,4,19,6,2.6812171936035156,3.3187828063964844
officetrashshadows_9,27,1,8,19,27.50861930847168,8.50861930847168
officetrashshadows_9,27,2,36,-9,-11.583715438842773,2.5837154388427734
officetrash_0,26,1,34,-8,-12.765626907348633,4.765626907348633
officetrash_1,23,1,41,-18,-7.564398765563965,10.435601234436035
officetrash_1,23,2,33,-10,-6.211970806121826,3.788029193878174
officetrash_2,25,1,11,14,8.87942886352539,5.120571136474609
officetrash_2,25,2,20,5,3.119931697845459,1.880068302154541
officetrash_4,33,1,35,-2,-5.1458001136779785,3.1458001136779785
officetrash_5,32,1,2,30,18.314207077026367,11.685792922973633
officetrash_5,32,2,20,12,13.925140380859375,1.925140380859375
officetrash_6,24,1,5,19,9.33617877960205,9.66382122039795
officetrash_6,24,2,14,10,7.555685043334961,2.444314956665039
officetrash_7,31,1,13,18,11.050406455993652,6.949593544006348
officetrash_7,31,2,24,7,9.868759155273438,2.8687591552734375
officetrash_8,25,1,2,23,18.692378997802734,4.307621002197266
outdoorsbalcony1_0,24,1,1,23,18.310155868530273,4.689844131469727
outdoorsbalcony1_1,23,1,25,-2,5.684593677520752,7.684593677520752
outdoorsbalcony1_1,23,2,31,-8,7.790094375610352,15.790094375610352
outdoorsbalcony1_1,23,3,39,-16,-8.753975868225098,7.246024131774902
outdoorsbalcony1_1,23,4,30,-7,-7.517175674438477,0.5171756744384766
outdoorsbalcony1_2,33,1,23,10,22.339672088623047,12.339672088623047
outdoorsbalcony1_2,33,2,45,-12,14.870979309082031,26.87097930908203
outdoorsbalcony1_2,33,3,48,-15,-10.830810546875,4.169189453125
outdoorsbalcony1_3,44,1,46,-2,-5.153428077697754,3.153428077697754
outdoorsbalcony1_4,29,1,19,10,6.8796491622924805,3.1203508377075195
outdoorsbalcony1_6,29,1,18,11,14.837021827697754,3.837021827697754
outdoorsbalcony1_9,38,1,5,33,9.43533706665039,23.56466293334961
outdoorsbalcony1_9,38,2,14,24,12.94104290008545,11.05895709991455
outdoorsbalcony1_9,38,3,27,11,9.12348461151123,1.8765153884887695
outdoorsbalcony2_0,23,1,4,19,15.112071990966797,3.887928009033203
outdoorsbalcony2_1,27,1,9,18,17.181781768798828,0.8182182312011719
outdoorsbalcony2_2,34,1,47,-13,-8.356998443603516,4.643001556396484
outdoorsbalcony2_4,21,1,46,-25,-10.876012802124023,14.123987197875977
outdoorsbalcony2_4,21,2,35,-14,-10.614736557006836,3.385263442993164
outdoorsbalcony2_5,23,1,0,23,25.965991973876953,2.965991973876953
outdoorsbalcony2_6,26,1,46,-20,-14.319744110107422,5.680255889892578
outdoorsbalcony2_6,26,2,32,-6,-8.97741985321045,2.977419853210449
outdoorsbalcony2_7,27,1,35,-8,-2.9818758964538574,5.018124103546143
outdoorsbalcony2_7,27,2,32,-5,-2.3997738361358643,2.6002261638641357
outdoorsbalcony2_8,24,1,27,-3,-2.4776127338409424,0.5223872661590576
outdoorsbalcony2_9,21,1,27,-6,-5.834618091583252,0.16538190841674805
outdoorsfossils_3,24,1,5,19,5.4901204109191895,13.509880065917969
outdoorsfossils_3,24,2,10,14,6.262232303619385,7.737767696380615
outdoorsfossils_3,24,3,16,8,1.4687389135360718,6.531260967254639
outdoorsfossils_3,24,4,17,7,1.9601434469223022,5.039856433868408
outdoorsfossils_3,24,5,19,5,-1.771051287651062,6.771051406860352
outdoorsfossils_3,24,6,17,7,3.8945744037628174,3.1054255962371826
outdoorsfossils_5,25,1,10,15,2.0295984745025635,12.970401763916016
outdoorsfossils_5,25,2,12,13,1.7887414693832397,11.211258888244629
outdoorsfossils_5,25,3,14,11,0.27045005559921265,10.7295503616333
outdoorsfossils_5,25,4,14,11,-0.4445371925830841,11.444537162780762
outdoorsfossils_5,25,5,14,11,-5.4295830726623535,16.429582595825195
outdoorsfossils_5,25,6,9,16,4.873924732208252,11.126075744628906
outdoorsfossils_5,25,7,14,11,-0.19944918155670166,11.19944953918457
outdoorsfossils_5,25,8,14,11,1.0094566345214844,9.990543365478516
outdoorsfossils_5,25,9,15,10,2.653240919113159,7.346758842468262
outdoorsfossils_5,25,10,18,7,-5.8729567527771,12.872957229614258
outdoorsfossils_6,24,1,15,9,4.874138832092285,4.125861167907715
outdoorsfossils_7,23,1,20,3,4.419703960418701,1.4197039604187012
outdoorsfossils_8,24,1,36,-12,-6.732443332672119,5.267556667327881
outdoorsfossils_8,24,2,29,-5,-0.2641686499118805,4.735831260681152
outdoorsfossils_9,25,1,39,-14,-5.23904275894165,8.760957717895508
outdoorsfossils_9,25,2,34,-9,-10.059813499450684,1.0598134994506836
outdoorsplants_0,37,1,45,-8,-7.576354503631592,0.4236454963684082
outdoorsplants_1,34,1,30,4,9.286808967590332,5.286808967590332
outdoorsplants_1,34,2,39,-5,21.78830337524414,26.78830337524414
outdoorsplants_1,34,3,48,-14,13.700827598571777,27.700828552246094
outdoorsplants_1,34,4,48,-14,9.46955680847168,23.46955680847168
outdoorsplants_1,34,5,48,-14,11.41080379486084,25.410804748535156
outdoorsplants_1,34,6,48,-14,17.99745750427246,31.99745750427246
outdoorsplants_1,34,7,48,-14,19.217294692993164,33.21729278564453
outdoorsplants_1,34,8,48,-14,14.182129859924316,28.18212890625
outdoorsplants_1,34,9,48,-14,15.854208946228027,29.854209899902344
outdoorsplants_1,34,10,48,-14,14.494175910949707,28.49417495727539
outdoorsplants_2,32,1,1,31,10.450854301452637,20.549144744873047
outdoorsplants_2,32,2,11,21,10.239127159118652,10.760872840881348
outdoorsplants_2,32,3,21,11,17.52512550354004,6.525125503540039
outdoorsplants_2,32,4,39,-7,12.662261962890625,19.662261962890625
outdoorsplants_2,32,5,48,-16,11.849315643310547,27.849315643310547
outdoorsplants_2,32,6,48,-16,18.91905403137207,34.91905212402344
outdoorsplants_2,32,7,48,-16,9.991214752197266,25.991214752197266
outdoorsplants_2,32,8,48,-16,9.735791206359863,25.735790252685547
outdoorsplants_2,32,9,48,-16,21.322542190551758,37.322540283203125
outdoorsplants_2,32,10,48,-16,11.819881439208984,27.819881439208984
outdoorsplants_3,23,1,39,-16,-17.74139976501465,1.7413997650146484
outdoorsplants_6,25,1,17,8,4.860271453857422,3.139728546142578
outdoorsplants_7,19,1,37,-18,-12.69297981262207,5.30702018737793
outdoorsplants_7,19,2,24,-5,-8.4375638961792,3.437563896179199
outdoorsplants_8,20,1,6,14,9.860590934753418,4.139409065246582
outdoorsplants_9,23,1,10,13,11.848143577575684,1.1518564224243164
photobox1_0,22,1,43,-21,1.6952426433563232,22.695241928100586
photobox1_0,22,2,45,-23,-6.991114139556885,16.008886337280273
photobox1_0,22,3,38,-16,-8.953263282775879,7.046736717224121
photobox1_0,22,4,29,-7,-2.8865950107574463,4.113405227661133
photobox1_1,22,1,2,20,18.627126693725586,1.372873306274414
photobox1_2,22,1,31,-9,-8.04832935333252,0.9516706466674805
photobox1_3,23,1,44,-21,-19.807037353515625,1.192962646484375
photobox1_4,21,1,3,18,15.167634010314941,2.8323659896850586
photobox1_5,22,1,40,-18,-6.398942470550537,11.601057052612305
photobox1_5,22,2,34,-12,-1.4336488246917725,10.566350936889648
photobox1_5,22,3,33,-11,-4.2476630210876465,6.7523369789123535
photobox1_5,22,4,29,-7,-3.2553904056549072,3.7446095943450928
photobox1_6,23,1,14,9,6.928567409515381,2.071432590484619
photobox1_7,22,1,37,-15,-22.914398193359375,7.914398193359375
photobox1_7,22,2,14,8,10.071666717529297,2.071666717529297
photobox1_8,22,1,37,-15,-6.88034200668335,8.119657516479492
photobox1_8,22,2,30,-8,-5.4921064376831055,2.5078935623168945
photobox1_9,26,1,19,7,3.3826966285705566,3.6173033714294434
photobox2_0,23,1,13,10,8.663641929626465,1.3363580703735352
photobox2_1,23,1,47,-24,-13.868830680847168,10.131169319152832
photobox2_1,23,2,33,-10,-6.924175262451172,3.075824737548828
photobox2_2,23,1,15,8,-1.2956209182739258,9.295620918273926
photobox2_2,23,2,14,9,8.134504318237305,0.8654956817626953
photobox2_3,23,1,42,-19,-2.954860210418701,16.04513931274414
photobox2_3,23,2,39,-16,3.008601427078247,19.008602142333984
photobox2_3,23,3,42,-19,-7.982568264007568,11.017431259155273
photobox2_3,23,4,34,-11,13.043941497802734,24.043941497802734
photobox2_3,23,5,47,-24,-7.5907087326049805,16.409290313720703
photobox2_3,23,6,39,-16,-9.41379165649414,6.586208343505859
photobox2_3,23,7,30,-7,-6.038856029510498,0.961143970489502
photobox2_4,24,1,17,7,8.929961204528809,1.9299612045288086
photobox2_5,26,1,5,21,11.870999336242676,9.129000663757324
photobox2_5,26,2,17,9,3.476292371749878,5.523707389831543
photobox2_5,26,3,20,6,-1.483860969543457,7.483860969543457
photobox2_5,26,4,19,7,1.5790493488311768,5.420950889587402
photobox2_5,26,5,21,5,4.147036552429199,0.8529634475708008
photobox2_6,22,1,25,-3,-5.084083080291748,2.084083080291748
photobox2_7,22,1,35,-13,-13.890192031860352,0.8901920318603516
photobox2_8,29,1,16,13,38.01054382324219,25.010543823242188
photobox2_8,29,2,48,-19,-7.227799892425537,11.772199630737305
photobox2_8,29,3,41,-12,-5.59647274017334,6.40352725982666
photobox2_8,29,4,35,-6,3.8349030017852783,9.8349027633667
photobox2_8,29,5,39,-10,-3.012202739715576,6.987797260284424
photobox2_8,29,6,36,-7,0.5440940260887146,7.544094085693359
photobox2_8,29,7,37,-8,-4.798094749450684,3.2019052505493164
photobox2_9,23,1,45,-22,-12.000029563903809,9.999970436096191
photobox2_9,23,2,33,-10,-6.719449520111084,3.280550479888916
randomsurplus_0,19,1,2,17,-0.3211113512516022,17.32111167907715
randomsurplus_0,19,2,2,17,2.067009210586548,14.932991027832031
randomsurplus_0,19,3,4,15,4.455874443054199,10.5441255569458
randomsurplus_0,19,4,8,11,8.268455505371094,2.7315444946289062
randomsurplus_1,41,1,29,12,10.343613624572754,1.656386375427246
randomsurplus_2,20,1,39,-19,-0.07179580628871918,18.928203582763672
randomsurplus_2,20,2,39,-19,-8.95788288116455,10.04211711883545
randomsurplus_2,20,3,30,-10,0.8226088881492615,10.822608947753906
randomsurplus_2,20,4,31,-11,-6.660284996032715,4.339715003967285
randomsurplus_3,29,1,15,14,17.8399715423584,3.8399715423583984
randomsurplus_4,29,1,45,-16,-9.916706085205078,6.083293914794922
randomsurplus_4,29,2,35,-6,-3.035335063934326,2.964664936065674
randomsurplus_5,21,1,1,20,15.677748680114746,4.322251319885254
randomsurplus_6,22,1,26,-4,-0.19965782761573792,3.800342082977295
randomsurplus_7,22,1,33,-11,3.393822193145752,14.393821716308594
randomsurplus_7,22,2,36,-14,-7.021082401275635,6.978917598724365
randomsurplus_7,22,3,29,-7,-10.769486427307129,3.769486427307129
randomsurplus_8,28,1,1,27,11.988051414489746,15.011948585510254
randomsurplus_8,28,2,13,15,0.24930281937122345,14.750697135925293
randomsurplus_8,28,3,13,15,6.634967803955078,8.365032196044922
randomsurplus_8,28,4,20,8,3.1539204120635986,4.8460798263549805
randomsurplus_9,28,1,12,16,9.862971305847168,6.137028694152832
randomsurplus_9,28,2,22,6,4.795691967010498,1.204308032989502
secondfloorbalcony_0,32,1,17,15,8.637201309204102,6.362798690795898
secondfloorbalcony_0,32,2,26,6,1.876962423324585,4.123037338256836
secondfloorbalcony_1,34,1,4,30,35.29047393798828,5.290473937988281
secondfloorbalcony_1,34,2,39,-5,-4.751697063446045,0.24830293655395508
secondfloorbalcony_3,20,1,23,-3,-7.30710506439209,4.30710506439209
secondfloorbalcony_4,23,1,1,22,10.122418403625488,11.877581596374512
secondfloorbalcony_4,23,2,11,12,5.03113317489624,6.96886682510376
secondfloorbalcony_4,23,3,16,7,9.260655403137207,2.260655403137207
secondfloorbalcony_6,23,1,6,17,13.463920593261719,3.5360794067382812
secondfloorbalcony_7,19,1,5,14,8.410856246948242,5.589143753051758
secondfloorbalcony_7,19,2,13,6,3.1553759574890137,2.8446240425109863
secondfloorbalcony_8,19,1,0,19,9.89378547668457,9.10621452331543
secondfloorbalcony_8,19,2,10,9,1.962343692779541,7.037656307220459
secondfloorbalcony_8,19,3,12,7,-2.0911803245544434,9.091180801391602
secondfloorbalcony_8,19,4,10,9,0.18362142145633698,8.816378593444824
secondfloorbalcony_8,19,5,10,9,3.741623640060425,5.258376121520996
secondfloorbalcony_8,19,6,14,5,-0.7710422277450562,5.771042346954346
secondfloorbalcony_8,19,7,13,6,-1.2561936378479004,7.2561936378479
secondfloorbalcony_8,19,8,12,7,-1.447654366493225,8.447654724121094
secondfloorbalcony_8,19,9,11,8,0.48968639969825745,7.510313510894775
secondfloorbalcony_8,19,10,11,8,-0.5504346489906311,8.550435066223145
secondfloorbalcony_9,21,1,30,-9,-14.342178344726562,5.3421783447265625
secondfloorbalcony_9,21,2,16,5,9.5883150100708,4.588315010070801
tableroom_0,19,1,33,-14,-13.329161643981934,0.6708383560180664
tableroom_1,22,1,47,-25,-17.259727478027344,7.740272521972656
tableroom_1,22,2,30,-8,-13.158742904663086,5.158742904663086
tableroom_1,22,3,17,5,5.457742691040039,0.45774269104003906
tableroom_2,44,1,32,12,37.33319091796875,25.33319091796875
tableroom_2,44,2,48,-4,30.4666805267334,34.46668243408203
tableroom_2,44,3,48,-4,32.231689453125,36.231689453125
tableroom_2,44,4,48,-4,27.966957092285156,31.966957092285156
tableroom_2,44,5,48,-4,29.34334373474121,33.343345642089844
tableroom_2,44,6,48,-4,21.920543670654297,25.920543670654297
tableroom_2,44,7,48,-4,22.30402946472168,26.30402946472168
tableroom_2,44,8,48,-4,29.388748168945312,33.38874816894531
tableroom_2,44,9,48,-4,25.083221435546875,29.083221435546875
tableroom_2,44,10,48,-4,32.5554313659668,36.5554313659668
tableroom_3,33,1,13,20,12.54894733428955,7.451052665710449
tableroom_3,33,2,26,7,5.617839813232422,1.3821601867675781
tableroom_4,45,1,16,29,28.55938148498535,0.44061851501464844
tableroom_5,33,1,10,23,19.309988021850586,3.690011978149414
