filename,CorrectPosition,focus_time,index,label,pred,loss
home1_0,29,1,34,-5,0.3369024991989136,5.336902618408203
home1_0,29,2,34,-5,6.994941711425781,11.994941711425781
home1_0,29,3,41,-12,4.139512538909912,16.13951301574707
home1_0,29,4,45,-16,-13.678882598876953,2.321117401123047
home1_1,23,1,29,-6,-14.848941802978516,8.848941802978516
home1_1,23,2,14,9,5.502537250518799,3.497462749481201
home1_2,37,1,5,32,23.7877254486084,8.212274551391602
home1_2,37,2,29,8,5.638982772827148,2.3610172271728516
home1_3,32,1,21,11,10.6845703125,0.3154296875
home1_4,47,1,32,15,9.05558967590332,5.94441032409668
home1_4,47,2,41,6,-7.772644519805908,13.77264404296875
home1_4,47,3,33,14,7.971752166748047,6.028247833251953
home1_4,47,4,41,6,-3.289196014404297,9.289196014404297
home1_4,47,5,38,9,-0.8987293243408203,9.89872932434082
home1_4,47,6,37,10,-4.140113830566406,14.140113830566406
home1_4,47,7,33,14,5.720588684082031,8.279411315917969
home1_4,47,8,39,8,-6.750344276428223,14.750344276428223
home1_4,47,9,32,15,9.9948091506958,5.005190849304199
home1_4,47,10,42,5,3.1646862030029297,1.8353137969970703
home1_5,47,1,13,34,34.95875549316406,0.9587554931640625
home1_6,34,1,16,18,16.361791610717773,1.6382083892822266
home1_8,29,1,19,10,12.60901927947998,2.6090192794799805
home1_9,26,1,46,-20,-10.306706428527832,9.693293571472168
home1_9,26,2,36,-10,-5.031946659088135,4.968053340911865
home2_0,38,1,40,-2,5.119867324829102,7.119867324829102
home2_0,38,2,45,-7,-2.137226104736328,4.862773895263672
home2_2,43,1,5,38,-3.6308038234710693,41.630802154541016
home2_2,43,2,1,42,-2.352269411087036,44.35226821899414
home2_2,43,3,0,43,5.69944429397583,37.30055618286133
home2_2,43,4,6,37,-0.9394915699958801,37.939491271972656
home2_2,43,5,5,38,0.06967755407094955,37.930320739746094
home2_2,43,6,5,38,-1.5966768264770508,39.596675872802734
home2_2,43,7,3,40,-0.64551842212677,40.6455192565918
home2_2,43,8,2,41,3.48496413230896,37.515037536621094
home2_2,43,9,5,38,2.8786771297454834,35.12132263183594
home2_2,43,10,8,35,-0.9944818019866943,35.99448013305664
home2_3,31,1,4,27,9.046636581420898,17.9533634185791
home2_3,31,2,13,18,7.451206684112549,10.54879379272461
home2_3,31,3,20,11,5.044541358947754,5.955458641052246
home2_3,31,4,25,6,-1.8416632413864136,7.841663360595703
home2_3,31,5,23,8,4.306506633758545,3.693493366241455
home2_4,34,1,41,-7,-5.2072834968566895,1.7927165031433105
home2_5,30,1,13,17,21.12689781188965,4.126897811889648
home2_6,29,1,45,-16,2.1804933547973633,18.180492401123047
home2_6,29,2,47,-18,2.2389872074127197,20.23898696899414
home2_6,29,3,48,-19,-3.385395050048828,15.614604949951172
home2_6,29,4,45,-16,-2.0669753551483154,13.933024406433105
home2_6,29,5,43,-14,-2.539581775665283,11.460418701171875
home2_6,29,6,40,-11,-2.628157615661621,8.371842384338379
home2_6,29,7,37,-8,2.901512384414673,10.901512145996094
home2_6,29,8,40,-11,-1.2552882432937622,9.744711875915527
home2_6,29,9,39,-10,2.3506550788879395,12.350654602050781
home2_6,29,10,41,-12,-1.054545283317566,10.945454597473145
home2_7,34,1,34,0,3.43161678314209,3.43161678314209
home2_9,30,1,29,1,5.741072177886963,4.741072177886963
microkitchen1_0,21,1,35,-14,-11.268614768981934,2.7313852310180664
microkitchen1_1,21,1,10,11,10.059752464294434,0.9402475357055664
microkitchen1_2,21,1,29,-8,-12.135324478149414,4.135324478149414
microkitchen1_3,24,1,14,10,8.974076271057129,1.025923728942871
microkitchen1_4,25,1,35,-10,3.239224910736084,13.239225387573242
microkitchen1_4,25,2,38,-13,-9.385873794555664,3.614126205444336
microkitchen1_5,25,1,19,6,8.448823928833008,2.448823928833008
microkitchen1_6,25,1,24,1,-1.9694271087646484,2.9694271087646484
microkitchen1_7,20,1,45,-25,-14.495054244995117,10.504945755004883
microkitchen1_7,20,2,31,-11,-9.046492576599121,1.953507423400879
microkitchen1_8,29,1,6,23,31.23717498779297,8.237174987792969
microkitchen1_8,29,2,37,-8,0.41057610511779785,8.410575866699219
microkitchen1_8,29,3,37,-8,-6.224765777587891,1.7752342224121094
microkitchen1_9,19,1,21,-2,-5.595443248748779,3.5954432487487793
pillowroom1_0,25,1,2,23,14.275449752807617,8.724550247192383
pillowroom1_0,25,2,16,9,21.731718063354492,12.731718063354492
pillowroom1_0,25,3,38,-13,8.424596786499023,21.424596786499023
pillowroom1_0,25,4,46,-21,-6.603557109832764,14.396442413330078
pillowroom1_0,25,5,39,-14,1.916327953338623,15.916328430175781
pillowroom1_0,25,6,41,-16,5.211458683013916,21.211458206176758
pillowroom1_0,25,7,46,-21,-1.4393435716629028,19.56065559387207
pillowroom1_0,25,8,45,-20,-2.4913034439086914,17.508697509765625
pillowroom1_0,25,9,43,-18,0.8206984996795654,18.820697784423828
pillowroom1_0,25,10,44,-19,4.410094738006592,23.41009521484375
pillowroom1_6,27,1,19,8,11.973360061645508,3.973360061645508
pillowroom1_7,36,1,2,34,11.950276374816895,22.049724578857422
pillowroom1_7,36,2,14,22,30.056241989135742,8.056241989135742
pillowroom1_7,36,3,44,-8,-6.171614646911621,1.828385353088379
pillowroom1_8,34,1,34,0,0.1074213907122612,0.1074213907122612
pillowroom1_9,21,1,30,-9,3.069725275039673,12.069725036621094
pillowroom1_9,21,2,33,-12,-8.307589530944824,3.692410469055176
secondfloorgames_0,20,1,14,6,2.6770637035369873,3.3229362964630127
secondfloorgames_1,24,1,13,11,-6.465510845184326,17.465511322021484
secondfloorgames_1,24,2,7,17,-11.273143768310547,28.273143768310547
secondfloorgames_1,24,3,0,24,-11.55112361907959,35.551124572753906
secondfloorgames_1,24,4,0,24,-5.294206619262695,29.294206619262695
secondfloorgames_1,24,5,0,24,-2.2991573810577393,26.299158096313477
secondfloorgames_1,24,6,0,24,-5.0065741539001465,29.006574630737305
secondfloorgames_1,24,7,0,24,-6.85067892074585,30.850679397583008
secondfloorgames_1,24,8,0,24,-7.111518383026123,31.11151885986328
secondfloorgames_1,24,9,0,24,-2.5903191566467285,26.59031867980957
secondfloorgames_1,24,10,0,24,-7.236537933349609,31.23653793334961
secondfloorgames_2,30,1,17,13,11.866158485412598,1.1338415145874023
secondfloorgames_3,23,1,3,20,23.88561248779297,3.8856124877929688
secondfloorgames_4,22,1,19,3,-1.2536015510559082,4.253601551055908
secondfloorgames_5,24,1,47,-23,-33.35122299194336,10.35122299194336
secondfloorgames_5,24,2,14,10,10.74575138092041,0.7457513809204102
secondfloorgames_6,19,1,28,-9,-9.52729606628418,0.5272960662841797
secondfloorgames_7,20,1,40,-20,-9.48847484588623,10.51152515411377
secondfloorgames_7,20,2,31,-11,-13.523331642150879,2.523331642150879
secondfloorgames_8,23,1,1,22,16.773351669311523,5.226648330688477
secondfloorgames_8,23,2,18,5,4.916711807250977,0.08328819274902344
apt1_0,25,1,35,-10,-11.616164207458496,1.616164207458496
apt1_1,21,1,14,7,6.661372661590576,0.33862733840942383
apt1_2,24,1,23,1,-6.7592058181762695,7.7592058181762695
apt1_2,24,2,16,8,-0.577542781829834,8.577543258666992
apt1_2,24,3,15,9,3.284437417984009,5.71556282043457
apt1_2,24,4,18,6,0.3249896764755249,5.6750102043151855
apt1_2,24,5,18,6,0.3660206198692322,5.633979320526123
apt1_2,24,6,18,6,2.3942782878875732,3.6057217121124268
apt1_3,25,1,0,25,16.7817325592041,8.218267440795898
apt1_3,25,2,17,8,12.6298828125,4.6298828125
apt1_4,23,1,30,-7,0.7632911801338196,7.763291358947754
apt1_4,23,2,31,-8,2.5193002223968506,10.51930046081543
apt1_4,23,3,34,-11,3.7207298278808594,14.72072982788086
apt1_4,23,4,38,-15,1.1648343801498413,16.16483497619629
apt1_4,23,5,39,-16,4.46567964553833,20.465679168701172
apt1_4,23,6,43,-20,0.05436982586979866,20.05436897277832
apt1_4,23,7,43,-20,4.7956862449646,24.795686721801758
apt1_4,23,8,48,-25,1.5781444311141968,26.578144073486328
apt1_4,23,9,48,-25,4.062922477722168,29.062923431396484
apt1_4,23,10,48,-25,3.1125974655151367,28.112598419189453
apt1_5,22,1,35,-13,1.0833922624588013,14.083392143249512
apt1_5,22,2,36,-14,-1.1641242504119873,12.835875511169434
apt1_5,22,3,35,-13,2.338823080062866,15.338823318481445
apt1_5,22,4,37,-15,4.616400241851807,19.61639976501465
apt1_5,22,5,42,-20,3.1341636180877686,23.13416290283203
apt1_5,22,6,45,-23,4.841516971588135,27.841516494750977
apt1_5,22,7,48,-26,2.2651937007904053,28.265193939208984
apt1_5,22,8,48,-26,3.3737270832061768,29.373727798461914
apt1_5,22,9,48,-26,0.7540283799171448,26.7540283203125
apt1_5,22,10,48,-26,-5.049088001251221,20.950912475585938
apt1_6,20,1,31,-11,-13.396876335144043,2.396876335144043
apt1_7,20,1,25,-5,-17.072065353393555,12.072065353393555
apt1_7,20,2,8,12,8.525111198425293,3.474888801574707
apt1_8,31,1,4,27,22.3796329498291,4.620367050170898
apt1_9,20,1,3,17,12.257195472717285,4.742804527282715
apt2_0,41,1,44,-3,5.836836338043213,8.836835861206055
apt2_0,41,2,48,-7,-0.8984389901161194,6.101561069488525
apt2_0,41,3,47,-6,6.047468185424805,12.047468185424805
apt2_0,41,4,48,-7,-4.387546062469482,2.6124539375305176
apt2_1,20,1,34,-14,-4.606834888458252,9.393165588378906
apt2_1,20,2,29,-9,-5.232796669006348,3.7672033309936523
apt2_2,23,1,23,0,5.642492771148682,5.642492771148682
apt2_2,23,2,29,-6,-1.2990270853042603,4.700973033905029
apt2_3,26,1,13,13,6.240960121154785,6.759039878845215
apt2_3,26,2,19,7,5.740956783294678,1.2590432167053223
apt2_4,23,1,33,-10,-2.39669132232666,7.60330867767334
apt2_4,23,2,31,-8,-11.07516098022461,3.0751609802246094
apt2_5,26,1,43,-17,-2.407137393951416,14.592863082885742
apt2_5,26,2,41,-15,-9.149219512939453,5.850780487060547
apt2_5,26,3,32,-6,-3.8488094806671143,2.1511905193328857
apt2_6,23,1,25,-2,-10.288911819458008,8.288911819458008
apt2_6,23,2,15,8,-4.00029993057251,12.000299453735352
apt2_6,23,3,11,12,0.5609602332115173,11.439040184020996
apt2_6,23,4,12,11,-11.5295991897583,22.529598236083984
apt2_6,23,5,0,23,-4.814332962036133,27.814332962036133
apt2_6,23,6,0,23,-4.674210071563721,27.674209594726562
apt2_6,23,7,0,23,-6.76233434677124,29.7623348236084
apt2_6,23,8,0,23,3.3550870418548584,19.644912719726562
apt2_6,23,9,3,20,-6.36608362197876,26.3660831451416
apt2_6,23,10,0,23,-12.250312805175781,35.25031280517578
apt2_7,31,1,25,6,6.5792646408081055,0.5792646408081055
apt2_8,40,1,23,17,14.235053062438965,2.764946937561035
apt2_9,24,1,7,17,10.176058769226074,6.823941230773926
apt2_9,24,2,17,7,-6.960921764373779,13.960922241210938
apt2_9,24,3,10,14,9.025518417358398,4.974481582641602
books_0,27,1,38,-11,-8.969151496887207,2.030848503112793
books_1,26,1,46,-20,-5.959960460662842,14.0400390625
books_1,26,2,40,-14,9.25574779510498,23.255748748779297
books_1,26,3,48,-22,-1.8814396858215332,20.118560791015625
books_1,26,4,46,-20,-1.4580005407333374,18.54199981689453
books_1,26,5,45,-19,-6.793754577636719,12.206245422363281
books_1,26,6,38,-12,-1.3153777122497559,10.684621810913086
books_1,26,7,37,-11,-6.411917686462402,4.588082313537598
books_2,22,1,4,18,10.606688499450684,7.393311500549316
books_2,22,2,15,7,3.659548282623291,3.340451717376709
books_3,23,1,26,-3,-10.043638229370117,7.043638229370117
books_3,23,2,16,7,1.8296679258346558,5.170331954956055
books_3,23,3,18,5,3.409447193145752,1.590552806854248
books_4,24,1,39,-15,-1.8850475549697876,13.114952087402344
books_4,24,2,37,-13,-9.910565376281738,3.0894346237182617
books_5,22,1,5,17,10.449481010437012,6.550518989562988
books_5,22,2,15,7,7.849344253540039,0.8493442535400391
books_6,20,1,12,8,10.034598350524902,2.0345983505249023
books_7,26,1,27,-1,4.339759349822998,5.339759349822998
books_7,26,2,31,-5,5.742426872253418,10.742426872253418
books_7,26,3,37,-11,5.459561347961426,16.45956039428711
books_7,26,4,42,-16,7.159191608428955,23.159191131591797
books_7,26,5,48,-22,6.975623607635498,28.975624084472656
books_7,26,6,48,-22,4.337304592132568,26.337305068969727
books_7,26,7,48,-22,5.3100128173828125,27.310012817382812
books_7,26,8,48,-22,4.867307186126709,26.867307662963867
books_7,26,9,48,-22,5.6662092208862305,27.666210174560547
books_7,26,10,48,-22,4.76820707321167,26.768207550048828
books_8,23,1,9,14,3.2132821083068848,10.786718368530273
books_8,23,2,12,11,0.5764902830123901,10.42350959777832
books_8,23,3,13,10,5.015931606292725,4.984068393707275
books_9,27,1,29,-2,4.209959506988525,6.209959506988525
books_9,27,2,33,-6,-1.788108468055725,4.2118916511535645
bottles_0,22,1,18,4,4.910676002502441,0.9106760025024414
bottles_1,23,1,14,9,7.732876300811768,1.2671236991882324
bottles_2,22,1,20,2,6.497251987457275,4.497251987457275
bottles_3,30,1,27,3,9.374211311340332,6.374211311340332
bottles_3,30,2,36,-6,6.89403772354126,12.894037246704102
bottles_3,30,3,43,-13,-7.748800277709961,5.251199722290039
bottles_3,30,4,35,-5,7.872509956359863,12.872509956359863
bottles_3,30,5,43,-13,-4.354273319244385,8.645727157592773
bottles_3,30,6,39,-9,-0.08638978004455566,8.913610458374023
bottles_3,30,7,39,-9,1.901198148727417,10.901198387145996
bottles_3,30,8,41,-11,-0.678225576877594,10.32177448272705
bottles_3,30,9,40,-10,5.5777812004089355,15.577781677246094
bottles_3,30,10,46,-16,-7.726317882537842,8.273681640625
bottles_4,25,1,11,14,9.158909797668457,4.841090202331543
bottles_5,27,1,43,-16,-9.532390594482422,6.467609405517578
bottles_5,27,2,33,-6,0.5224105715751648,6.5224103927612305
bottles_5,27,3,34,-7,-8.323500633239746,1.323500633239746
bottles_6,27,1,24,3,5.582746505737305,2.5827465057373047
bottles_7,27,1,8,19,17.29256248474121,1.707437515258789
bottles_8,25,1,25,0,-6.546486854553223,6.546486854553223
bottles_8,25,2,18,7,12.194722175598145,5.1947221755981445
bottles_8,25,3,30,-5,-5.395873546600342,0.3958735466003418
campusoutdoors1_0,20,1,39,-19,-24.276477813720703,5.276477813720703
campusoutdoors1_0,20,2,15,5,-10.32658576965332,15.32658576965332
campusoutdoors1_0,20,3,5,15,7.007868766784668,7.992131233215332
campusoutdoors1_0,20,4,12,8,-6.238907814025879,14.238907814025879
campusoutdoors1_0,20,5,6,14,11.567498207092285,2.432501792907715
campusoutdoors1_1,20,1,10,10,12.17591381072998,2.1759138107299805
campusoutdoors1_2,22,1,3,19,18.63405990600586,0.3659400939941406
campusoutdoors1_3,20,1,14,6,-7.818974018096924,13.818973541259766
campusoutdoors1_3,20,2,6,14,5.74504280090332,8.25495719909668
campusoutdoors1_3,20,3,12,8,-2.074634313583374,10.074634552001953
campusoutdoors1_3,20,4,10,10,3.5804312229156494,6.41956901550293
campusoutdoors1_3,20,5,14,6,-6.332678318023682,12.332677841186523
campusoutdoors1_3,20,6,8,12,-0.5034621357917786,12.503461837768555
campusoutdoors1_3,20,7,7,13,6.414613246917725,6.585386753082275
campusoutdoors1_3,20,8,13,7,-5.643328666687012,12.643328666687012
campusoutdoors1_3,20,9,7,13,7.579687118530273,5.420312881469727
campusoutdoors1_3,20,10,15,5,-7.194268703460693,12.194269180297852
campusoutdoors1_4,22,1,14,8,5.868302345275879,2.131697654724121
campusoutdoors1_5,22,1,5,17,13.756710052490234,3.2432899475097656
campusoutdoors1_6,27,1,44,-17,-11.591621398925781,5.408378601074219
campusoutdoors1_6,27,2,32,-5,4.587096691131592,9.58709716796875
campusoutdoors1_6,27,3,37,-10,-5.08430814743042,4.91569185256958
campusoutdoors1_8,19,1,39,-20,-14.612442016601562,5.3875579833984375
campusoutdoors1_8,19,2,24,-5,-13.757187843322754,8.757187843322754
campusoutdoors1_8,19,3,10,9,6.043539524078369,2.956460475921631
campusoutdoors1_9,19,1,35,-16,-14.288119316101074,1.7118806838989258
campusoutdoors2_0,20,1,26,-6,-5.331450462341309,0.6685495376586914
campusoutdoors2_1,42,1,14,28,28.360366821289062,0.3603668212890625
campusoutdoors2_3,31,1,6,25,13.39050006866455,11.60949993133545
campusoutdoors2_3,31,2,19,12,5.959183216094971,6.040816783905029
campusoutdoors2_3,31,3,25,6,4.5569281578063965,1.4430718421936035
campusoutdoors2_4,29,1,7,22,18.20698356628418,3.7930164337158203
campusoutdoors2_5,32,1,43,-11,-6.950334072113037,4.049665927886963
campusoutdoors2_6,22,1,14,8,8.072772026062012,0.07277202606201172
campusoutdoors2_7,23,1,16,7,6.719762802124023,0.28023719787597656
campusoutdoors2_8,23,1,31,-8,-11.98161506652832,3.9816150665283203
campusoutdoors2_9,25,1,30,-5,-5.404355525970459,0.404355525970459
fakeplants_0,24,1,29,-5,0.9691578149795532,5.969157695770264
fakeplants_0,24,2,30,-6,0.9025980234146118,6.902597904205322
fakeplants_0,24,3,31,-7,1.1695382595062256,8.169538497924805
fakeplants_0,24,4,32,-8,2.5777170658111572,10.577716827392578
fakeplants_0,24,5,35,-11,-1.3741319179534912,9.62586784362793
fakeplants_0,24,6,34,-10,3.2103610038757324,13.21036148071289
fakeplants_0,24,7,37,-13,-0.4715201258659363,12.52847957611084
fakeplants_0,24,8,37,-13,2.7427642345428467,15.742764472961426
fakeplants_0,24,9,40,-16,-3.2336301803588867,12.766369819641113
fakeplants_0,24,10,37,-13,2.33136248588562,15.3313627243042
fakeplants_1,21,1,35,-14,-11.525984764099121,2.474015235900879
fakeplants_2,21,1,10,11,7.239232063293457,3.760767936706543
fakeplants_3,22,1,1,21,9.195444107055664,11.804555892944336
fakeplants_3,22,2,10,12,5.310719966888428,6.689280033111572
fakeplants_3,22,3,15,7,1.6762843132019043,5.323715686798096
fakeplants_3,22,4,17,5,6.56423807144165,1.5642380714416504
fakeplants_4,24,1,34,-10,-10.771666526794434,0.7716665267944336
fakeplants_5,21,1,32,-11,-2.767160654067993,8.232839584350586
fakeplants_5,21,2,29,-8,0.07996880263090134,8.079968452453613
fakeplants_5,21,3,29,-8,-3.9207985401153564,4.079201698303223
fakeplants_6,21,1,47,-26,-11.437105178833008,14.562894821166992
fakeplants_6,21,2,36,-15,-8.675052642822266,6.324947357177734
fakeplants_6,21,3,27,-6,-5.4254961013793945,0.5745038986206055
fakeplants_7,23,1,13,10,10.773650169372559,0.7736501693725586
fakeplants_8,21,1,17,4,-1.4658092260360718,5.465809345245361
fakeplants_8,21,2,16,5,4.097844123840332,0.902155876159668
fakeplants_9,21,1,37,-16,-4.331137180328369,11.668863296508789
fakeplants_9,21,2,33,-12,-4.0875630378723145,7.9124369621276855
fakeplants_9,21,3,29,-8,-5.218798637390137,2.7812013626098633
garage2_0,22,1,9,13,10.91545295715332,2.0845470428466797
garage2_1,24,1,9,15,9.994916915893555,5.005083084106445
garage2_1,24,2,19,5,8.67240047454834,3.67240047454834
garage2_2,31,1,38,-7,-0.6857275366783142,6.314272403717041
garage2_2,31,2,37,-6,4.473798751831055,10.473798751831055
garage2_2,31,3,41,-10,10.305248260498047,20.305248260498047
garage2_2,31,4,48,-17,0.824445366859436,17.824445724487305
garage2_2,31,5,48,-17,-8.166295051574707,8.833704948425293
garage2_2,31,6,40,-9,4.464521408081055,13.464521408081055
garage2_2,31,7,44,-13,3.0834243297576904,16.083423614501953
garage2_2,31,8,47,-16,7.278106212615967,23.278106689453125
garage2_2,31,9,48,-17,3.1808152198791504,20.180814743041992
garage2_2,31,10,48,-17,17.63890266418457,34.63890075683594
garage2_4,24,1,44,-20,-13.994385719299316,6.005614280700684
garage2_4,24,2,30,-6,-8.47972297668457,2.4797229766845703
garage2_6,26,1,35,-9,-6.443767070770264,2.5562329292297363
garage2_7,24,1,43,-19,-13.03472900390625,5.96527099609375
garage2_7,24,2,30,-6,-2.19744610786438,3.80255389213562
garage2_8,21,1,35,-14,-7.570479869842529,6.429520130157471
garage2_8,21,2,27,-6,-5.366526126861572,0.6334738731384277
garage2_9,23,1,18,5,-3.8126814365386963,8.812681198120117
garage2_9,23,2,14,9,2.657464027404785,6.342535972595215
garage2_9,23,3,17,6,8.590132713317871,2.590132713317871
garage_0,25,1,47,-22,-7.497312545776367,14.502687454223633
garage_0,25,2,40,-15,-4.439376354217529,10.560623168945312
garage_0,25,3,36,-11,-0.6291834712028503,10.370816230773926
garage_0,25,4,35,-10,-7.126628398895264,2.8733716011047363
garage_1,27,1,13,14,1.4206652641296387,12.579334259033203
garage_1,27,2,14,13,2.0013649463653564,10.998635292053223
garage_1,27,3,16,11,2.3640174865722656,8.635982513427734
garage_1,27,4,18,9,-1.9332325458526611,10.933232307434082
garage_1,27,5,16,11,-2.884182929992676,13.884182929992676
garage_1,27,6,13,14,2.6692097187042236,11.330790519714355
garage_1,27,7,16,11,-5.4966864585876465,16.496686935424805
garage_1,27,8,11,16,-2.5909016132354736,18.59090232849121
garage_1,27,9,8,19,-5.187589645385742,24.187589645385742
garage_1,27,10,3,24,-2.3632471561431885,26.36324691772461
garage_3,22,1,42,-20,-8.599924087524414,11.400075912475586
garage_3,22,2,33,-11,-5.514401435852051,5.485598564147949
garage_3,22,3,27,-5,-2.528430461883545,2.471569538116455
garage_4,44,1,25,19,9.63845157623291,9.36154842376709
garage_4,44,2,35,9,4.554778099060059,4.445221900939941
garage_6,27,1,3,24,12.032590866088867,11.967409133911133
garage_6,27,2,15,12,7.227738857269287,4.772261142730713
garage_7,22,1,13,9,8.926337242126465,0.07366275787353516
garage_8,44,1,10,34,42.2175407409668,8.217540740966797
garage_8,44,2,48,-4,-9.8115873336792,5.811587333679199
garage_8,44,3,38,6,10.256338119506836,4.256338119506836
garage_9,20,1,15,5,8.294289588928223,3.2942895889282227
hallway1_0,32,1,46,-14,-6.117825984954834,7.882174015045166
hallway1_0,32,2,40,-8,-9.878464698791504,1.878464698791504
hallway1_2,33,1,15,18,21.041913986206055,3.0419139862060547
hallway1_3,26,1,34,-8,0.8441038727760315,8.844103813171387
hallway1_3,26,2,35,-9,-1.7533988952636719,7.246601104736328
hallway1_3,26,3,33,-7,-1.0328037738800049,5.967196464538574
hallway1_3,26,4,32,-6,-5.218651294708252,0.781348705291748
hallway1_4,23,1,20,3,12.225789070129395,9.225789070129395
hallway1_4,23,2,32,-9,-5.42521333694458,3.57478666305542
hallway1_5,22,1,16,6,6.320135593414307,0.32013559341430664
hallway1_6,22,1,19,3,4.37711238861084,1.3771123886108398
hallway1_7,37,1,4,33,33.597415924072266,0.5974159240722656
hallway2_0,29,1,28,1,13.184749603271484,12.184749603271484
hallway2_0,29,2,41,-12,-6.388599395751953,5.611400604248047
hallway2_0,29,3,35,-6,2.9634079933166504,8.963407516479492
hallway2_0,29,4,38,-9,-3.246040105819702,5.753959655761719
hallway2_0,29,5,35,-6,7.978255748748779,13.978256225585938
hallway2_0,29,6,43,-14,-2.641000509262085,11.358999252319336
hallway2_0,29,7,40,-11,4.322787761688232,15.32278823852539
hallway2_0,29,8,44,-15,-7.299256801605225,7.700743198394775
hallway2_0,29,9,37,-8,4.837898254394531,12.837898254394531
hallway2_0,29,10,42,-13,0.8015733957290649,13.801573753356934
hallway2_1,34,1,8,26,3.743469715118408,22.25653076171875
hallway2_1,34,2,12,22,1.2951240539550781,20.704875946044922
hallway2_1,34,3,13,21,2.858712911605835,18.141286849975586
hallway2_1,34,4,16,18,4.949098110198975,13.050901412963867
hallway2_1,34,5,21,13,3.861363172531128,9.138636589050293
hallway2_1,34,6,25,9,3.518735885620117,5.481264114379883
hallway2_1,34,7,29,5,4.689807415008545,0.3101925849914551
hallway2_2,25,1,14,11,14.274650573730469,3.2746505737304688
meetingroom1_7,19,1,12,7,1.595778465270996,5.404221534729004
meetingroom1_7,19,2,14,5,7.60977029800415,2.6097702980041504
meetingroom1_8,21,1,48,-27,-10.69659423828125,16.30340576171875
meetingroom1_8,21,2,37,-16,-7.766367435455322,8.233633041381836
meetingroom1_8,21,3,29,-8,2.714742422103882,10.714742660522461
meetingroom1_8,21,4,32,-11,-8.589449882507324,2.410550117492676
meetingroom1_9,23,1,42,-19,-16.846837997436523,2.1531620025634766
meetingroom2_0,27,1,16,11,-2.993441104888916,13.993440628051758
meetingroom2_0,27,2,13,14,0.12280505895614624,13.877195358276367
meetingroom2_0,27,3,13,14,1.5416936874389648,12.458306312561035
meetingroom2_0,27,4,15,12,-0.5641844868659973,12.564184188842773
meetingroom2_0,27,5,14,13,-3.237456798553467,16.237457275390625
meetingroom2_0,27,6,11,16,1.9401917457580566,14.059808731079102
meetingroom2_0,27,7,13,14,-1.4963972568511963,15.496397018432617
meetingroom2_0,27,8,12,15,0.34366706013679504,14.656332969665527
meetingroom2_0,27,9,12,15,-5.549757480621338,20.54975700378418
meetingroom2_0,27,10,6,21,-0.4721602201461792,21.47216033935547
meetingroom2_1,23,1,13,10,12.263516426086426,2.263516426086426
meetingroom2_2,24,1,16,8,3.88777494430542,4.11222505569458
meetingroom2_3,29,1,12,17,6.039425849914551,10.96057415008545
meetingroom2_3,29,2,18,11,3.5627541542053223,7.437245845794678
meetingroom2_3,29,3,22,7,3.785015821456909,3.214984178543091
meetingroom2_4,22,1,1,21,0.6545000672340393,20.34549903869629
meetingroom2_4,22,2,2,20,-4.844487190246582,24.844486236572266
meetingroom2_4,22,3,0,22,4.865772724151611,17.134227752685547
meetingroom2_4,22,4,5,17,-0.04529879614710808,17.045299530029297
meetingroom2_4,22,5,5,17,-4.233753204345703,21.233753204345703
meetingroom2_4,22,6,1,21,3.46355938911438,17.536439895629883
meetingroom2_4,22,7,4,18,-0.6516038179397583,18.65160369873047
meetingroom2_4,22,8,3,19,-2.7476117610931396,21.74761199951172
meetingroom2_4,22,9,0,22,4.045654773712158,17.954345703125
meetingroom2_4,22,10,4,18,-0.33688631653785706,18.336885452270508
meetingroom2_5,24,1,23,1,-1.0328524112701416,2.0328524112701416
meetingroom2_6,26,1,23,3,8.880805969238281,5.880805969238281
meetingroom2_6,26,2,32,-6,-13.35068416595459,7.35068416595459
meetingroom2_6,26,3,19,7,11.29764461517334,4.29764461517334
meetingroom2_7,28,1,11,17,22.40633773803711,5.406337738037109
meetingroom2_7,28,2,33,-5,-3.8580987453460693,1.1419012546539307
meetingroom2_8,28,1,10,18,25.38336753845215,7.383367538452148
meetingroom2_8,28,2,35,-7,-15.730277061462402,8.730277061462402
meetingroom2_8,28,3,19,9,15.996824264526367,6.996824264526367
meetingroom2_8,28,4,35,-7,-13.55700397491455,6.557003974914551
meetingroom2_8,28,5,21,7,14.198412895202637,7.198412895202637
meetingroom2_8,28,6,35,-7,-0.233925461769104,6.7660746574401855
meetingroom2_8,28,7,35,-7,-8.753278732299805,1.7532787322998047
meetingroom2_9,31,1,14,17,20.364280700683594,3.3642807006835938
officecrawl1_0,26,1,16,10,-12.724989891052246,22.724990844726562
officecrawl1_0,26,2,3,23,-7.2211384773254395,30.22113800048828
officecrawl1_0,26,3,0,26,-7.841980934143066,33.84197998046875
officecrawl1_0,26,4,0,26,-5.041555881500244,31.041555404663086
officecrawl1_0,26,5,0,26,-4.56509256362915,30.565092086791992
officecrawl1_0,26,6,0,26,-7.658350467681885,33.65835189819336
officecrawl1_0,26,7,0,26,3.919429063796997,22.080570220947266
officecrawl1_0,26,8,4,22,-3.213934898376465,25.21393585205078
officecrawl1_0,26,9,1,25,-5.071021556854248,30.071022033691406
officecrawl1_0,26,10,0,26,-5.740185737609863,31.740184783935547
officecrawl1_1,36,1,19,17,6.868561744689941,10.131438255310059
officecrawl1_1,36,2,26,10,5.9050469398498535,4.0949530601501465
officecrawl1_2,26,1,25,1,-9.698753356933594,10.698753356933594
officecrawl1_2,26,2,15,11,8.331827163696289,2.668172836303711
officecrawl1_3,21,1,8,13,2.2745139598846436,10.725485801696777
officecrawl1_3,21,2,10,11,-4.691596508026123,15.691596984863281
officecrawl1_3,21,3,5,16,-9.82829475402832,25.82829475402832
officecrawl1_3,21,4,0,21,1.686383605003357,19.313615798950195
officecrawl1_3,21,5,2,19,-4.239718914031982,23.23971939086914
officecrawl1_3,21,6,0,21,-5.864659309387207,26.86465835571289
officecrawl1_3,21,7,0,21,-9.000450134277344,30.000450134277344
officecrawl1_3,21,8,0,21,-3.917310953140259,24.91731071472168
officecrawl1_3,21,9,0,21,-4.016520977020264,25.016521453857422
officecrawl1_3,21,10,0,21,-15.228681564331055,36.22868347167969
officecrawl1_4,31,1,39,-8,-13.888398170471191,5.888398170471191
officecrawl1_4,31,2,25,6,8.714360237121582,2.714360237121582
officecrawl1_5,23,1,4,19,0.15541085600852966,18.844589233398438
officecrawl1_5,23,2,4,19,-5.86977481842041,24.869773864746094
officecrawl1_5,23,3,0,23,-6.461074352264404,29.461074829101562
officecrawl1_5,23,4,0,23,-1.756760835647583,24.75676155090332
officecrawl1_5,23,5,0,23,-4.758075714111328,27.758075714111328
officecrawl1_5,23,6,0,23,-3.9533309936523438,26.953330993652344
officecrawl1_5,23,7,0,23,-5.686828136444092,28.68682861328125
officecrawl1_5,23,8,0,23,-5.92147159576416,28.921470642089844
officecrawl1_5,23,9,0,23,-1.4133120775222778,24.413312911987305
officecrawl1_5,23,10,0,23,-1.2111481428146362,24.21114730834961
officecrawl1_6,27,1,45,-18,-13.239225387573242,4.760774612426758
officecrawl1_7,20,1,20,0,8.187051773071289,8.187051773071289
officecrawl1_7,20,2,28,-8,8.807380676269531,16.80738067626953
officecrawl1_7,20,3,37,-17,-1.5727547407150269,15.427245140075684
officecrawl1_7,20,4,35,-15,2.1386513710021973,17.13865089416504
officecrawl1_7,20,5,37,-17,-3.5515120029449463,13.448488235473633
officecrawl1_7,20,6,33,-13,4.018359661102295,17.018360137939453
officecrawl1_7,20,7,37,-17,4.505979537963867,21.505979537963867
officecrawl1_7,20,8,42,-22,-6.8256402015686035,15.174360275268555
officecrawl1_7,20,9,35,-15,-5.566561222076416,9.433439254760742
officecrawl1_7,20,10,29,-9,2.9188854694366455,11.918885231018066
officecrawl1_8,32,1,41,-9,-10.129069328308105,1.1290693283081055
officecrawl1_9,33,1,7,26,22.667978286743164,3.332021713256836
officecrawl2_0,31,1,15,16,1.4373929500579834,14.562606811523438
officecrawl2_0,31,2,16,15,4.939079761505127,10.060920715332031
officecrawl2_0,31,3,21,10,6.630236625671387,3.3697633743286133
officecrawl2_1,24,1,31,-7,-6.655377388000488,0.3446226119995117
officecrawl2_2,48,1,7,41,8.966580390930176,32.03342056274414
officecrawl2_2,48,2,16,32,9.53891658782959,22.461082458496094
officecrawl2_2,48,3,26,22,7.593832492828369,14.406167984008789
officecrawl2_2,48,4,34,14,5.318665504455566,8.681334495544434
officecrawl2_2,48,5,39,9,4.249676704406738,4.750323295593262
officecrawl2_3,42,1,27,15,11.065275192260742,3.934724807739258
officecrawl2_4,24,1,34,-10,6.979841709136963,16.979841232299805
officecrawl2_4,24,2,41,-17,-3.623814344406128,13.376185417175293
officecrawl2_4,24,3,37,-13,-0.61131751537323,12.38868236541748
officecrawl2_4,24,4,36,-12,-9.028641700744629,2.971358299255371
officecrawl2_6,28,1,2,26,8.337966918945312,17.662033081054688
officecrawl2_6,28,2,10,18,10.19962215423584,7.80037784576416
officecrawl2_6,28,3,20,8,6.873706817626953,1.1262931823730469
officecrawl2_7,33,1,12,21,21.20061492919922,0.20061492919921875
officecrawl2_8,22,1,9,13,11.240309715270996,1.759690284729004
officecrawl2_9,27,1,12,15,3.8006412982940674,11.199358940124512
officecrawl2_9,27,2,16,11,4.788283824920654,6.211716175079346
officecrawl2_9,27,3,21,6,7.018900394439697,1.0189003944396973
officecrawl3_1,26,1,9,17,19.126874923706055,2.1268749237060547
officecrawl3_2,24,1,34,-10,-10.207293510437012,0.20729351043701172
officecrawl3_3,32,1,46,-14,-7.427702903747559,6.572297096252441
officecrawl3_3,32,2,39,-7,-3.237409830093384,3.762590169906616
officecrawl3_4,20,1,32,-12,-11.129999160766602,0.8700008392333984
officecrawl3_5,27,1,44,-17,-3.0031399726867676,13.99686050415039
officecrawl3_5,27,2,41,-14,-6.268335342407227,7.731664657592773
officecrawl3_5,27,3,35,-8,-7.5826096534729,0.4173903465270996
officecrawl3_6,26,1,41,-15,-11.747764587402344,3.2522354125976562
officecrawl3_7,28,1,1,27,7.85660982131958,19.143390655517578
officecrawl3_7,28,2,9,19,6.4621710777282715,12.53782844543457
officecrawl3_7,28,3,15,13,9.675701141357422,3.324298858642578
officecrawl3_8,19,1,39,-20,-11.179542541503906,8.820457458496094
officecrawl3_8,19,2,28,-9,-13.754002571105957,4.754002571105957
officecrawl3_9,25,1,37,-12,-8.966960906982422,3.033039093017578
officeroom1_0,27,1,39,-12,-12.246514320373535,0.24651432037353516
officeroom1_1,28,1,47,-19,-6.330927848815918,12.669072151184082
officeroom1_1,28,2,41,-13,0.10968882590532303,13.109688758850098
officeroom1_1,28,3,41,-13,-0.27032747864723206,12.7296724319458
officeroom1_1,28,4,41,-13,-6.351810932159424,6.648189067840576
officeroom1_1,28,5,35,-7,5.369693756103516,12.369693756103516
officeroom1_1,28,6,40,-12,-7.5228142738342285,4.4771857261657715
officeroom1_2,29,1,40,-11,-2.594911813735962,8.405088424682617
officeroom1_2,29,2,37,-8,0.365039199590683,8.365038871765137
officeroom1_2,29,3,37,-8,-1.943219542503357,6.0567803382873535
officeroom1_2,29,4,35,-6,6.218165874481201,12.21816635131836
officeroom1_2,29,5,41,-12,-3.914522886276245,8.085476875305176
officeroom1_2,29,6,37,-8,0.5649061799049377,8.564906120300293
officeroom1_2,29,7,38,-9,-3.9868037700653076,5.013195991516113
officeroom1_2,29,8,34,-5,-2.921358346939087,2.078641653060913
officeroom1_3,29,1,23,6,13.198806762695312,7.1988067626953125
officeroom1_3,29,2,36,-7,-3.467602252960205,3.532397747039795
officeroom1_4,21,1,9,12,8.850889205932617,3.149110794067383
officeroom1_5,22,1,16,6,0.8725350499153137,5.127464771270752
officeroom1_5,22,2,17,5,4.534503936767578,0.4654960632324219
officeroom1_6,22,1,15,7,4.381446838378906,2.6185531616210938
officeroom1_7,22,1,11,11,-6.949644088745117,17.949644088745117
officeroom1_7,22,2,4,18,-3.833843469619751,21.833843231201172
officeroom1_7,22,3,0,22,-7.517156600952148,29.51715660095215
officeroom1_7,22,4,0,22,-10.196014404296875,32.196014404296875
officeroom1_7,22,5,0,22,-10.03711223602295,32.037113189697266
officeroom1_7,22,6,0,22,-6.520075798034668,28.520076751708984
officeroom1_7,22,7,0,22,-8.55711841583252,30.557117462158203
officeroom1_7,22,8,0,22,-11.14136791229248,33.1413688659668
officeroom1_7,22,9,0,22,-2.929917812347412,24.92991828918457
officeroom1_7,22,10,0,22,-6.5788044929504395,28.57880401611328
officeroom1_8,22,1,38,-16,3.947437047958374,19.947437286376953
officeroom1_8,22,2,42,-20,-14.859909057617188,5.1400909423828125
officeroom1_8,22,3,27,-5,-8.663261413574219,3.6632614135742188
officeroom1_9,27,1,20,7,16.33359146118164,9.33359146118164
officeroom1_9,27,2,36,-9,-6.60931921005249,2.3906807899475098
officetrashshadows_1,34,1,28,6,-2.916476249694824,8.916476249694824
officetrashshadows_1,34,2,25,9,-3.096233606338501,12.096233367919922
officetrashshadows_1,34,3,22,12,-5.869667053222656,17.869667053222656
officetrashshadows_1,34,4,16,18,-3.291618824005127,21.29161834716797
officetrashshadows_1,34,5,13,21,6.906207084655762,14.093792915344238
officetrashshadows_1,34,6,20,14,-2.0519065856933594,16.05190658569336
officetrashshadows_1,34,7,18,16,-3.6614575386047363,19.661457061767578
officetrashshadows_1,34,8,14,20,-0.4886213541030884,20.48862075805664
officetrashshadows_1,34,9,14,20,-3.570347547531128,23.57034683227539
officetrashshadows_1,34,10,10,24,-1.7925218343734741,25.792522430419922
officetrashshadows_2,23,1,15,8,7.366946220397949,0.6330537796020508
officetrashshadows_3,27,1,6,21,17.80836296081543,3.1916370391845703
officetrashshadows_4,36,1,21,15,14.511517524719238,0.4884824752807617
officetrashshadows_5,39,1,4,35,6.342418193817139,28.657581329345703
officetrashshadows_5,39,2,10,29,5.192055702209473,23.807945251464844
officetrashshadows_5,39,3,15,24,9.835785865783691,14.164214134216309
officetrashshadows_5,39,4,25,14,10.277402877807617,3.722597122192383
officetrashshadows_6,37,1,26,11,6.864725589752197,4.135274410247803
officetrashshadows_8,25,1,5,20,13.17249870300293,6.82750129699707
officetrashshadows_8,25,2,18,7,1.6872237920761108,5.3127760887146
officetrashshadows_8,25,3,20,5,4.52857780456543,0.4714221954345703
officetrashshadows_9,27,1,37,-10,-9.589765548706055,0.4102344512939453
officetrash_0,26,1,42,-16,-12.072151184082031,3.9278488159179688
officetrash_1,23,1,27,-4,0.07138809561729431,4.071388244628906
officetrash_2,25,1,12,13,12.100642204284668,0.899357795715332
officetrash_4,33,1,37,-4,-2.484072208404541,1.515927791595459
officetrash_5,32,1,42,-10,-12.746230125427246,2.746230125427246
officetrash_6,24,1,33,-9,-7.839400768280029,1.1605992317199707
officetrash_7,31,1,4,27,20.006500244140625,6.993499755859375
officetrash_7,31,2,24,7,8.543868064880371,1.543868064880371
officetrash_8,25,1,6,19,12.390936851501465,6.609063148498535
officetrash_8,25,2,18,7,5.139673709869385,1.8603262901306152
outdoorsbalcony1_0,24,1,47,-23,-11.052081108093262,11.947918891906738
outdoorsbalcony1_0,24,2,36,-12,-15.189958572387695,3.1899585723876953
outdoorsbalcony1_1,23,1,41,-18,-7.853903770446777,10.146096229553223
outdoorsbalcony1_1,23,2,33,-10,-9.513906478881836,0.48609352111816406
outdoorsbalcony1_2,33,1,26,7,13.172237396240234,6.172237396240234
outdoorsbalcony1_2,33,2,39,-6,-5.631792068481445,0.3682079315185547
outdoorsbalcony1_3,44,1,0,44,49.63786697387695,5.637866973876953
outdoorsbalcony1_3,44,2,48,-4,-11.952079772949219,7.952079772949219
outdoorsbalcony1_3,44,3,36,8,8.863049507141113,0.8630495071411133
outdoorsbalcony1_4,29,1,29,0,3.927380084991455,3.927380084991455
outdoorsbalcony1_6,29,1,1,28,19.499521255493164,8.500478744506836
outdoorsbalcony1_6,29,2,20,9,13.063776016235352,4.063776016235352
outdoorsbalcony1_9,38,1,5,33,16.38208770751953,16.61791229248047
outdoorsbalcony1_9,38,2,21,17,14.739558219909668,2.260441780090332
outdoorsbalcony2_0,23,1,27,-4,4.523940086364746,8.523940086364746
outdoorsbalcony2_0,23,2,32,-9,-8.355647087097168,0.644352912902832
outdoorsbalcony2_1,27,1,37,-10,-10.028538703918457,0.02853870391845703
outdoorsbalcony2_2,34,1,2,32,16.07756233215332,15.92243766784668
outdoorsbalcony2_2,34,2,18,16,9.155564308166504,6.844435691833496
outdoorsbalcony2_2,34,3,27,7,5.637271404266357,1.3627285957336426
outdoorsbalcony2_4,21,1,45,-24,-2.4564597606658936,21.543540954589844
outdoorsbalcony2_4,21,2,43,-22,-8.96281909942627,13.03718090057373
outdoorsbalcony2_4,21,3,34,-13,-11.279301643371582,1.720698356628418
outdoorsbalcony2_5,23,1,38,-15,-9.52726936340332,5.47273063659668
outdoorsbalcony2_5,23,2,28,-5,-5.604976177215576,0.6049761772155762
outdoorsbalcony2_6,26,1,20,6,6.560080051422119,0.5600800514221191
outdoorsbalcony2_7,27,1,31,-4,2.6374194622039795,6.637419700622559
outdoorsbalcony2_7,27,2,34,-7,-2.273228168487549,4.726771831512451
outdoorsbalcony2_8,24,1,18,6,14.018465042114258,8.018465042114258
outdoorsbalcony2_8,24,2,32,-8,1.4823697805404663,9.482369422912598
outdoorsbalcony2_8,24,3,33,-9,-7.160870552062988,1.8391294479370117
outdoorsbalcony2_9,21,1,9,12,9.670708656311035,2.329291343688965
outdoorsfossils_3,24,1,47,-23,-10.534784317016602,12.465215682983398
outdoorsfossils_3,24,2,36,-12,-10.810431480407715,1.1895685195922852
outdoorsfossils_5,25,1,16,9,-0.8201130628585815,9.820113182067871
outdoorsfossils_5,25,2,15,10,-1.8239942789077759,11.823994636535645
outdoorsfossils_5,25,3,13,12,1.3392236232757568,10.660776138305664
outdoorsfossils_5,25,4,14,11,0.06837359815835953,10.931626319885254
outdoorsfossils_5,25,5,14,11,1.9409921169281006,9.05900764465332
outdoorsfossils_5,25,6,16,9,-6.251723289489746,15.251723289489746
outdoorsfossils_5,25,7,10,15,6.679754257202148,8.320245742797852
outdoorsfossils_5,25,8,17,8,-0.8205538988113403,8.82055377960205
outdoorsfossils_5,25,9,16,9,-0.8668903708457947,9.866889953613281
outdoorsfossils_5,25,10,15,10,1.7376313209533691,8.262369155883789
outdoorsfossils_6,24,1,15,9,6.787489414215088,2.212510585784912
outdoorsfossils_7,23,1,6,17,11.266486167907715,5.733513832092285
outdoorsfossils_7,23,2,17,6,6.874419689178467,0.8744196891784668
outdoorsfossils_8,24,1,25,-1,3.5062851905822754,4.506285190582275
outdoorsfossils_9,25,1,16,9,9.269755363464355,0.26975536346435547
outdoorsplants_0,37,1,1,36,13.697504043579102,22.3024959564209
outdoorsplants_0,37,2,15,22,20.91293716430664,1.0870628356933594
outdoorsplants_1,34,1,41,-7,16.873044967651367,23.873044967651367
outdoorsplants_1,34,2,48,-14,14.158278465270996,28.158279418945312
outdoorsplants_1,34,3,48,-14,16.713207244873047,30.713207244873047
outdoorsplants_1,34,4,48,-14,12.721803665161133,26.721803665161133
outdoorsplants_1,34,5,48,-14,9.682750701904297,23.682750701904297
outdoorsplants_1,34,6,48,-14,10.966033935546875,24.966033935546875
outdoorsplants_1,34,7,48,-14,12.833154678344727,26.833154678344727
outdoorsplants_1,34,8,48,-14,14.224834442138672,28.224834442138672
outdoorsplants_1,34,9,48,-14,18.952680587768555,32.95268249511719
outdoorsplants_1,34,10,48,-14,13.77470874786377,27.774707794189453
outdoorsplants_2,32,1,27,5,22.522380828857422,17.522380828857422
outdoorsplants_2,32,2,48,-16,16.515676498413086,32.51567840576172
outdoorsplants_2,32,3,48,-16,12.446682929992676,28.44668197631836
outdoorsplants_2,32,4,48,-16,14.196807861328125,30.196807861328125
outdoorsplants_2,32,5,48,-16,13.59819221496582,29.59819221496582
outdoorsplants_2,32,6,48,-16,12.28841781616211,28.28841781616211
outdoorsplants_2,32,7,48,-16,10.11201286315918,26.11201286315918
outdoorsplants_2,32,8,48,-16,11.94251823425293,27.94251823425293
outdoorsplants_2,32,9,48,-16,13.554403305053711,29.55440330505371
outdoorsplants_2,32,10,48,-16,11.365975379943848,27.36597442626953
outdoorsplants_3,23,1,19,4,4.421647548675537,0.4216475486755371
outdoorsplants_6,25,1,42,-17,-17.035497665405273,0.03549766540527344
outdoorsplants_7,19,1,38,-19,-14.260696411132812,4.7393035888671875
outdoorsplants_8,20,1,48,-28,-7.772266864776611,20.227733612060547
outdoorsplants_8,20,2,40,-20,-8.066337585449219,11.933662414550781
outdoorsplants_8,20,3,32,-12,-11.782453536987305,0.2175464630126953
outdoorsplants_9,23,1,36,-13,-5.8457722663879395,7.1542277336120605
outdoorsplants_9,23,2,30,-7,-1.7169491052627563,5.283051013946533
outdoorsplants_9,23,3,28,-5,-3.78482985496521,1.21517014503479
photobox1_0,22,1,29,-7,-4.374154567718506,2.625845432281494
photobox1_1,22,1,43,-21,-9.595451354980469,11.404548645019531
photobox1_1,22,2,33,-11,-10.136733055114746,0.8632669448852539
photobox1_2,22,1,35,-13,-10.877908706665039,2.122091293334961
photobox1_3,23,1,2,21,19.32168197631836,1.6783180236816406
photobox1_4,21,1,42,-21,-10.483918190002441,10.516081809997559
photobox1_4,21,2,32,-11,-12.852132797241211,1.852132797241211
photobox1_5,22,1,15,7,1.2110034227371216,5.788996696472168
photobox1_5,22,2,16,6,2.188572883605957,3.811427116394043
photobox1_6,23,1,17,6,-6.811593532562256,12.811594009399414
photobox1_6,23,2,10,13,-6.119870185852051,19.119869232177734
photobox1_6,23,3,4,19,-6.493910789489746,25.493911743164062
photobox1_6,23,4,0,23,-0.23236240446567535,23.232362747192383
photobox1_6,23,5,0,23,-9.482693672180176,32.48269271850586
photobox1_6,23,6,0,23,-5.1833109855651855,28.183311462402344
photobox1_6,23,7,0,23,-3.33367657661438,26.333677291870117
photobox1_6,23,8,0,23,-6.4159321784973145,29.415931701660156
photobox1_6,23,9,0,23,-4.378353118896484,27.378353118896484
photobox1_6,23,10,0,23,-3.8792738914489746,26.879274368286133
photobox1_7,22,1,23,-1,-6.770200729370117,5.770200729370117
photobox1_7,22,2,16,6,1.47177255153656,4.52822732925415
photobox1_8,22,1,41,-19,-10.261852264404297,8.738147735595703
photobox1_8,22,2,31,-9,0.18396122753620148,9.183960914611816
photobox1_8,22,3,31,-9,-1.2074445486068726,7.792555332183838
photobox1_8,22,4,30,-8,-2.894804000854492,5.105195999145508
photobox1_8,22,5,27,-5,0.786318838596344,5.786318778991699
photobox1_8,22,6,28,-6,-3.0530893802642822,2.9469106197357178
photobox1_9,26,1,15,11,8.029083251953125,2.970916748046875
photobox2_0,23,1,5,18,13.93331241607666,4.06668758392334
photobox2_1,23,1,45,-22,-16.984542846679688,5.0154571533203125
photobox2_1,23,2,28,-5,-5.722573280334473,0.7225732803344727
photobox2_2,23,1,47,-24,-14.521039009094238,9.478960990905762
photobox2_2,23,2,32,-9,-14.607036590576172,5.607036590576172
photobox2_2,23,3,17,6,5.815305709838867,0.1846942901611328
photobox2_3,23,1,21,2,4.813694000244141,2.8136940002441406
photobox2_4,24,1,41,-17,-12.063485145568848,4.936514854431152
photobox2_5,26,1,16,10,8.333572387695312,1.6664276123046875
photobox2_6,22,1,37,-15,-8.114593505859375,6.885406494140625
photobox2_6,22,2,29,-7,-10.465511322021484,3.4655113220214844
photobox2_7,22,1,32,-10,-9.493491172790527,0.5065088272094727
photobox2_8,29,1,0,29,31.558483123779297,2.558483123779297
photobox2_9,23,1,11,12,16.12702751159668,4.12702751159668
randomsurplus_0,19,1,27,-8,-18.431171417236328,10.431171417236328
randomsurplus_0,19,2,9,10,-4.258321285247803,14.258321762084961
randomsurplus_0,19,3,5,14,-4.205621242523193,18.20562171936035
randomsurplus_0,19,4,1,18,7.6885271072387695,10.31147289276123
randomsurplus_0,19,5,9,10,-14.014130592346191,24.014129638671875
randomsurplus_0,19,6,0,19,9.109621047973633,9.890378952026367
randomsurplus_0,19,7,9,10,8.363289833068848,1.6367101669311523
randomsurplus_1,41,1,45,-4,0.12270786613225937,4.122707843780518
randomsurplus_2,20,1,21,-1,1.427232265472412,2.427232265472412
randomsurplus_3,29,1,46,-17,-6.520370960235596,10.479629516601562
randomsurplus_3,29,2,39,-10,-0.8687452077865601,9.131255149841309
randomsurplus_3,29,3,38,-9,-2.035198926925659,6.964800834655762
randomsurplus_3,29,4,36,-7,3.818481922149658,10.8184814453125
randomsurplus_3,29,5,40,-11,-8.237070083618164,2.762929916381836
randomsurplus_4,29,1,39,-10,-9.598705291748047,0.4012947082519531
randomsurplus_5,21,1,27,-6,-1.5376381874084473,4.462361812591553
randomsurplus_6,22,1,6,16,9.911197662353516,6.088802337646484
randomsurplus_6,22,2,16,6,4.385894298553467,1.6141057014465332
randomsurplus_7,22,1,38,-16,-8.911105155944824,7.088894844055176
randomsurplus_7,22,2,29,-7,-11.064364433288574,4.064364433288574
randomsurplus_8,28,1,22,6,6.861257076263428,0.8612570762634277
randomsurplus_9,28,1,38,-10,-9.444011688232422,0.5559883117675781
secondfloorbalcony_0,32,1,19,13,8.862091064453125,4.137908935546875
secondfloorbalcony_1,34,1,14,20,30.578981399536133,10.578981399536133
secondfloorbalcony_1,34,2,45,-11,-7.6372809410095215,3.3627190589904785
secondfloorbalcony_3,20,1,24,-4,-15.97011947631836,11.97011947631836
secondfloorbalcony_3,20,2,8,12,3.876908540725708,8.123091697692871
secondfloorbalcony_3,20,3,12,8,2.276083469390869,5.723916530609131
secondfloorbalcony_3,20,4,14,6,0.6936373114585876,5.306362628936768
secondfloorbalcony_3,20,5,15,5,-2.7483971118927,7.748396873474121
secondfloorbalcony_3,20,6,12,8,1.8942049741744995,6.105794906616211
secondfloorbalcony_3,20,7,14,6,-0.641233503818512,6.641233444213867
secondfloorbalcony_3,20,8,13,7,0.581092119216919,6.41890811920166
secondfloorbalcony_3,20,9,14,6,3.268329381942749,2.731670618057251
secondfloorbalcony_4,23,1,31,-8,-13.077486038208008,5.077486038208008
secondfloorbalcony_4,23,2,18,5,-4.3824381828308105,9.382438659667969
secondfloorbalcony_4,23,3,14,9,-9.509918212890625,18.509918212890625
secondfloorbalcony_4,23,4,4,19,4.393499374389648,14.606500625610352
secondfloorbalcony_4,23,5,8,15,0.17624573409557343,14.82375431060791
secondfloorbalcony_4,23,6,8,15,11.749579429626465,3.250420570373535
secondfloorbalcony_6,23,1,9,14,12.69172477722168,1.3082752227783203
secondfloorbalcony_7,19,1,13,6,7.81706428527832,1.8170642852783203
secondfloorbalcony_8,19,1,31,-12,-6.288351535797119,5.711648464202881
secondfloorbalcony_8,19,2,25,-6,-2.3581879138946533,3.6418120861053467
secondfloorbalcony_9,21,1,22,-1,-11.173416137695312,10.173416137695312
secondfloorbalcony_9,21,2,11,10,5.757735252380371,4.242264747619629
tableroom_0,19,1,27,-8,-10.348637580871582,2.348637580871582
tableroom_1,22,1,16,6,8.784431457519531,2.7844314575195312
tableroom_2,44,1,23,21,23.06767463684082,2.0676746368408203
tableroom_3,33,1,44,-11,-8.804763793945312,2.1952362060546875
tableroom_4,45,1,35,10,13.447031021118164,3.447031021118164
tableroom_5,33,1,31,2,7.295683860778809,5.295683860778809
tableroom_5,33,2,38,-5,-9.066204071044922,4.066204071044922
